District Code,District Name,Building Code,Building Name,free_lunch_eligible,reduced_price_lunch_eligible,Not Eligible,Total Count
01010,Alcona Community Schools,00044,Alcona Community High School,92,39,183,314
01010,Alcona Community Schools,04937,Alcona Elementary School,176,28,136,340
01010,Alcona Community Schools,08833,Alcona Middle School,115,18,112,245
02010,AuTrain-Onota Public Schools,04959,AuTrain-Onota Public School,22,5,17,44
02020,Burt Township School District,04999,Burt Township School,30,4,7,41
02070,Munising Public Schools,00597,William G. Mather Elementary School,152,25,173,350
02070,Munising Public Schools,01928,Munising High and Middle School,99,27,202,328
02080,Superior Central Schools,04860,Superior Central School,109,52,221,382
03000,Allegan Area Educational Service Agency,06730,Hillside Learning & Behavior Center,71,18,39,128
03000,Allegan Area Educational Service Agency,09075,Wayland Young Adult Program,1,0,7,8
03000,Allegan Area Educational Service Agency,09076,Plainwell Young Adult Program,1,0,8,9
03010,Plainwell Community Schools,00790,Cooper Elementary School,48,19,208,275
03010,Plainwell Community Schools,01403,Gilkey Elementary School,73,16,277,366
03010,Plainwell Community Schools,03065,Plainwell High School,149,42,685,876
03010,Plainwell Community Schools,04056,Starr Elementary School,233,34,279,546
03010,Plainwell Community Schools,06000,Plainwell Middle School,171,37,439,647
03010,Plainwell Community Schools,08016,Renaissance High School,30,5,22,57
03020,Otsego Public Schools,00922,Dix Street Elementary School,140,22,185,347
03020,Otsego Public Schools,02863,Otsego Middle School,153,38,315,506
03020,Otsego Public Schools,02864,Washington Street Elementary School,166,27,238,431
03020,Otsego Public Schools,02865,Otsego High School,141,50,514,705
03020,Otsego Public Schools,04851,Alamo Elementary School,63,22,175,260
03020,Otsego Public Schools,09525,Otsego West Campus High School,27,3,23,53
03030,Allegan Public Schools,00059,L.E. White Middle School,221,67,281,569
03030,Allegan Public Schools,00062,Allegan High School,211,64,555,830
03030,Allegan Public Schools,00881,Dawson Elementary School,157,26,167,350
03030,Allegan Public Schools,02748,North Ward Elementary School,124,30,133,287
03030,Allegan Public Schools,03535,Allegan Alternative High School,88,5,57,150
03030,Allegan Public Schools,04469,West Ward Elementary School,111,31,168,310
03030,Allegan Public Schools,05954,Pine Trails Elementary School,174,22,140,336
03040,Wayland Union Schools,00307,Bessie B. Baker School,179,43,178,400
03040,Wayland Union Schools,00936,Dorr School,136,52,314,502
03040,Wayland Union Schools,03224,R.J. Steeby School,94,30,114,238
03040,Wayland Union Schools,04404,Wayland High School,216,76,647,939
03040,Wayland Union Schools,06778,Pine Street Elementary,122,50,236,408
03040,Wayland Union Schools,08421,Wayland Union Middle School,145,49,256,450
03050,Fennville Public Schools,01217,Fennville Public High School,250,55,153,458
03050,Fennville Public Schools,05790,Pearl Alternative/Adult Education School,35,2,34,71
03050,Fennville Public Schools,07311,Fennville Middle School,196,29,92,317
03050,Fennville Public Schools,07494,Fennville Elementary School,434,78,161,673
03060,Martin Public Schools,02402,Martin High School,118,32,149,299
03060,Martin Public Schools,06034,Robert D. Brandon Elem. School,135,26,148,309
03070,Hopkins Public Schools,01756,Hopkins Elementary School,148,45,223,416
03070,Hopkins Public Schools,01757,Hopkins High School,139,33,386,558
03070,Hopkins Public Schools,06025,Sycamore Elementary School,57,32,274,363
03070,Hopkins Public Schools,08807,Hopkins Middle School,94,35,224,353
03080,Saugatuck Public Schools,00941,Douglas Elementary School,112,38,264,414
03080,Saugatuck Public Schools,03409,Saugatuck High School,55,28,164,247
03080,Saugatuck Public Schools,08889,Saugatuck Middle School,55,16,125,196
03100,Hamilton Community Schools,01545,Hamilton Elementary School,90,36,328,454
03100,Hamilton Community Schools,01547,Hamilton High School,108,59,626,793
03100,Hamilton Community Schools,01548,Blue Star Elementary School,78,14,214,306
03100,Hamilton Community Schools,03403,Sandyview Elementary School,24,12,98,134
03100,Hamilton Community Schools,04975,Bentheim Elementary School,38,34,227,299
03100,Hamilton Community Schools,08890,Hamilton Middle School,105,61,434,600
03440,Glenn Public School District,01415,Glenn Public School,11,3,27,41
03902,Outlook Academy,09085,Outlook Academy,13,8,4,25
03902,Outlook Academy,09987,Outlook Academy - Youth Home Campus,28,0,0,28
04000,Alpena-Montmorency-Alcona ESD,00808,Pied Piper Opportunity Center,35,6,29,70
04000,Alpena-Montmorency-Alcona ESD,09473,ESD Sp Ed Programs in LEA Facilities,9,0,12,21
04010,Alpena Public Schools,00075,Alpena High School,445,141,924,1510
04010,Alpena Public Schools,00106,Besser Elementary School,178,30,234,442
04010,Alpena Public Schools,01110,Ella M. White School,173,32,177,382
04010,Alpena Public Schools,01688,Hinks School,98,29,136,263
04010,Alpena Public Schools,02185,Lincoln Community School,144,11,40,195
04010,Alpena Public Schools,02251,Long Rapids Elementary School,58,17,88,163
04010,Alpena Public Schools,03392,Sanborn School,140,31,115,286
04010,Alpena Public Schools,04552,Wilson Community School,82,26,82,190
04010,Alpena Public Schools,05499,Sunset Elementary School,88,22,80,190
04010,Alpena Public Schools,05507,Thunder Bay Junior High School,234,60,355,649
04010,Alpena Public Schools,07361,OxBow ACES Academy/Alternative and Adult Ed,115,8,48,171
04901,Bingham Academy,09444,Bingham Academy,88,10,44,142
05010,Alba Public Schools,06938,Alba School,117,37,59,213
05035,Central Lake Public Schools,00609,Central Lake Public School,168,38,172,378
05040,Bellaire Public Schools,00261,Bellaire Middle/High School,90,22,179,291
05040,Bellaire Public Schools,05894,John R Rodger Elementary School,101,24,108,233
05060,Elk Rapids Schools,00662,Elk Rapids High School,105,17,387,509
05060,Elk Rapids Schools,00665,Cherryland Middle School,104,28,217,349
05060,Elk Rapids Schools,02090,Lakeland Elementary School,123,32,223,378
05060,Elk Rapids Schools,07458,Mill Creek Elementary School,78,27,208,313
05065,Ellsworth Community School,05859,Ellsworth Community School,74,31,125,230
05070,Mancelona Public Schools,02332,Mancelona Elementary School,275,70,98,443
05070,Mancelona Public Schools,02333,Mancelona High School,147,65,124,336
05070,Mancelona Public Schools,06599,Mancelona Middle School,176,50,90,316
05901,Concord Montessori and Community School,08626,Concord Montessori and Community School,118,0,51,169
06010,Arenac Eastern School District,06950,Arenac Eastern Middle/High School,96,26,41,163
06010,Arenac Eastern School District,09267,Arenac Eastern Elementary School,79,10,18,107
06020,Au Gres-Sims School District,00146,Au Gres-Sims Elementary School,97,21,71,189
06020,Au Gres-Sims School District,00147,Au Gres-Sims Middle and High School,85,27,99,211
06050,Standish-Sterling Community Schools,04049,Standish Elementary School,201,26,176,403
06050,Standish-Sterling Community Schools,04050,Standish-Sterling Central High School,224,47,319,590
06050,Standish-Sterling Community Schools,04068,Sterling Elementary School,126,27,120,273
06050,Standish-Sterling Community Schools,08901,Standish-Sterling Middle School,247,56,233,536
07010,Arvon Township School District,00128,Arvon Township School,2,0,3,5
07020,Baraga Area Schools,00198,Baraga Area High School,121,19,135,275
07020,Baraga Area Schools,02992,Pelkie Elementary School,67,6,41,114
07020,Baraga Area Schools,05784,Philip Latendresse School,80,17,57,154
07040,L'Anse Area Schools,04149,L'Anse High School,80,24,163,267
07040,L'Anse Area Schools,05002,Sullivan Elementary School,129,33,140,302
07040,L'Anse Area Schools,08841,L'Anse Middle School,57,31,91,179
08000,Barry ISD,08881,Barry ISD Special Education,30,6,19,55
08010,Delton-Kellogg School District,00900,Delton-Kellogg High School,155,38,303,496
08010,Delton-Kellogg School District,00901,Delton Kellogg Elem. School,257,49,268,574
08010,Delton-Kellogg School District,06422,Delton-Kellogg Middle School,159,54,251,464
08010,Delton-Kellogg School District,07761,Delton-Kellogg Alternative H.S.,65,8,57,130
08030,Hastings Area School District,00077,Northeastern Elementary School,131,40,171,342
08030,Hastings Area School District,01606,Central Elementary School,155,27,190,372
08030,Hastings Area School District,01607,Hastings Middle School,207,65,419,691
08030,Hastings Area School District,03541,Southeastern Elementary School,171,34,95,300
08030,Hastings Area School District,05882,Hastings High School,208,90,636,934
08030,Hastings Area School District,08469,Star Elementary School,104,33,197,334
08050,Thornapple Kellogg School District,02579,McFall Elementary School,129,33,366,528
08050,Thornapple Kellogg School District,04176,Thornapple Kellogg High School,152,80,657,889
08050,Thornapple Kellogg School District,04444,Lee Elementary School,100,33,306,439
08050,Thornapple Kellogg School District,05806,Thornapple Kellogg Middle School,155,61,436,652
08050,Thornapple Kellogg School District,07253,Page Elementary School,100,47,289,436
08050,Thornapple Kellogg School District,08179,Alternative Education,6,0,18,24
09000,Bay-Arenac ISD,07276,Detention Center,5,0,7,12
09000,Bay-Arenac ISD,08912,LLC---Bay Campus,61,10,40,111
09000,Bay-Arenac ISD,08913,LLC--Arenac Campus,21,2,9,32
09000,Bay-Arenac ISD,09735,ISD-Local Programs,47,5,45,97
09010,Bay City School District,00150,Auburn Elementary School,141,38,341,520
09010,Bay City School District,00227,Bay City Central High School,571,137,749,1457
09010,Bay City School District,01011,Forest Center,7,2,26,35
09010,Bay City School District,01553,Hampton Elementary School,189,45,291,525
09010,Bay City School District,02235,Linsday Elementary School,234,38,88,360
09010,Bay City School District,02309,Mackensen Elementary School,52,19,267,338
09010,Bay City School District,02467,Western Middle School,201,54,622,877
09010,Bay City School District,04123,Handy Middle School,604,103,406,1113
09010,Bay City School District,04361,Washington Elementary School,428,31,67,526
09010,Bay City School District,05463,McAlear-Sawden Elem. School,168,40,377,585
09010,Bay City School District,06257,Bay City Western High School,239,71,1008,1318
09010,Bay City School District,06966,Kolb Elementary School,241,49,240,530
09010,Bay City School District,06967,MacGregor Elementary School,380,45,76,501
09010,Bay City School District,08573,Wenona Center Home of Wenona High/Middle School,124,14,48,186
09010,Bay City School District,08914,Bay City Adult Education/CTP,34,0,42,76
09010,Bay City School District,09080,Jefferson Center,17,0,25,42
09030,Bangor Township Schools,00186,Bangor Central School,231,36,126,393
09030,Bangor Township Schools,00190,Christa McAuliffe Middle School,242,43,311,596
09030,Bangor Township Schools,00191,Bangor Lincoln School,143,30,129,302
09030,Bangor Township Schools,00194,Bangor West Central School,102,25,176,303
09030,Bangor Township Schools,01951,John Glenn High School,270,55,563,888
09050,Essexville-Hampton Public Schools,01358,Garber High School,148,31,471,650
09050,Essexville-Hampton Public Schools,01789,Hughes Elementary School,78,21,157,256
09050,Essexville-Hampton Public Schools,04290,Verellen Elementary School,75,17,148,240
09050,Essexville-Hampton Public Schools,04321,W.R. Bush Elementary School,68,7,203,278
09050,Essexville-Hampton Public Schools,05966,Cramer Junior High School,121,27,312,460
09090,Pinconning Area Schools,02236,Linwood Elementary School,68,16,100,184
09090,Pinconning Area Schools,02628,Mt. Forest Elementary School,77,23,63,163
09090,Pinconning Area Schools,03040,Pinconning High School,187,61,359,607
09090,Pinconning Area Schools,03041,Pinconning Central Elementary School,194,30,129,353
09090,Pinconning Area Schools,06656,Pinconning Middle School,93,25,122,240
09090,Pinconning Area Schools,08827,Pinconning Advancement Academy,1,0,2,3
09901,Bay-Arenac Community High School,05453,Bay-Arenac Community High School,68,0,81,149
09902,Bay County PSA,08856,Bay County PSA,172,24,38,234
10015,Benzie County Central Schools,00287,Benzie Central Sr. High School,246,82,237,565
10015,Benzie County Central Schools,00848,Crystal Lake Elementary School,127,20,66,213
10015,Benzie County Central Schools,03067,Platte River Elementary School,164,44,112,320
10015,Benzie County Central Schools,05591,Betsie Valley School,109,20,39,168
10015,Benzie County Central Schools,06952,Benzie Central Middle School,127,50,98,275
10015,Benzie County Central Schools,08846,Lake Ann Elementary School,112,45,123,280
10025,Frankfort-Elberta Area Schools,01298,Frankfort Elementary School,120,37,130,287
10025,Frankfort-Elberta Area Schools,01299,Frankfort High School,103,35,125,263
11000,Berrien RESA,02577,Berrien County Juvenile Center,33,0,14,47
11000,Berrien RESA,05794,Lighthouse Education Center,52,9,43,104
11000,Berrien RESA,06922,Blossomland Learning Center,126,9,84,219
11000,Berrien RESA,09637,Community Based Early Childhood Services,9,0,9,18
11010,Benton Harbor Area Schools,00286,Benton Harbor High School,738,44,93,875
11010,Benton Harbor Area Schools,00373,Boynton Montessori Program,167,14,29,210
11010,Benton Harbor Area Schools,00500,Calvin Britain Elementary School,259,5,23,287
11010,Benton Harbor Area Schools,01181,Fair Plain West Elementary School,269,16,15,300
11010,Benton Harbor Area Schools,01629,Morton Elementary School,267,5,10,282
11010,Benton Harbor Area Schools,01792,Hull Middle School,267,6,12,285
11010,Benton Harbor Area Schools,02068,Creative Arts/Gifted and Talented Academy,185,22,33,240
11010,Benton Harbor Area Schools,03502,Sorter Elementary School,183,11,13,207
11010,Benton Harbor Area Schools,06197,McCord Elementary School,276,6,9,291
11010,Benton Harbor Area Schools,07143,Fair Plain Renaissance MIddle School,340,27,15,382
11010,Benton Harbor Area Schools,09555,MLK Freshman Academy,215,14,25,254
11010,Benton Harbor Area Schools,09556,Fair Plain Northwest Learning Academy,66,3,15,84
11010,Benton Harbor Area Schools,09557,Stump School,9,1,1,11
11010,Benton Harbor Area Schools,09893,Stump Early Childhood Center,7,0,8,15
11020,St. Joseph Public Schools,00422,Brown School,40,11,277,328
11020,St. Joseph Public Schools,00992,Clarke School,48,11,379,438
11020,St. Joseph Public Schools,02211,Lincoln School,84,13,319,416
11020,St. Joseph Public Schools,03793,St. Joseph High School,117,45,765,927
11020,St. Joseph Public Schools,05793,Upton Middle School,96,36,587,719
11030,Lakeshore School District (Berrien),01700,Hollywood Elementary School,115,32,292,439
11030,Lakeshore School District (Berrien),02095,Lakeshore High School,130,36,756,922
11030,Lakeshore School District (Berrien),02097,Lakeshore Middle School,121,42,509,672
11030,Lakeshore School District (Berrien),02098,Roosevelt Elementary School,63,14,359,436
11030,Lakeshore School District (Berrien),02099,Stewart Elementary School,104,36,324,464
11033,River Valley School District,00670,Chikaming Elementary School,61,16,51,128
11033,River Valley School District,03209,River Valley Middle School,80,23,81,184
11033,River Valley School District,03740,River Valley High School,75,20,120,215
11033,River Valley School District,04180,Three Oaks Elementary School,81,37,66,184
11160,Galien Township School District,01354,Wolford Elementary School,33,9,20,62
11160,Galien Township School District,06934,Galien Township Middle School,16,2,6,24
11160,Galien Township School District,09535,Galien Alternative Education School,41,3,43,87
11200,New Buffalo Area Schools,02677,New Buffalo Senior High School,73,27,172,272
11200,New Buffalo Area Schools,02678,New Buffalo Elementary School,81,20,123,224
11200,New Buffalo Area Schools,08503,New Buffalo Middle School,50,26,88,164
11210,Brandywine Community Schools,00386,Brandywine Elementary School,188,33,161,382
11210,Brandywine Community Schools,00387,Brandywine Senior High School,144,56,233,433
11210,Brandywine Community Schools,08161,Bell Education Center,29,5,12,46
11210,Brandywine Community Schools,08303,Merritt Elementary School,157,23,156,336
11210,Brandywine Community Schools,08845,Brandywine Middle School,117,21,91,229
11240,Berrien Springs Public Schools,00296,Berrien Springs Middle School,254,52,174,480
11240,Berrien Springs Public Schools,00297,Berrien Springs High School,233,43,295,571
11240,Berrien Springs Public Schools,00298,Mars Elementary School,204,29,132,365
11240,Berrien Springs Public Schools,00299,Sylvester Elementary School,246,34,139,419
11240,Berrien Springs Public Schools,09086,Berrien Springs Alternative Education Center,60,7,95,162
11250,Eau Claire Public Schools,01061,Eau Claire High School,133,34,91,258
11250,Eau Claire Public Schools,02288,Lybrook Elementary School,304,20,75,399
11250,Eau Claire Public Schools,09916,Eau Claire Middle School,110,12,53,175
11300,Niles Community School District,00184,Ballard Elementary School,376,43,232,651
11300,Niles Community School District,01056,Eastside Elementary School,211,25,114,350
11300,Niles Community School District,01771,Howard Community School,239,47,225,511
11300,Niles Community School District,02704,Niles Senior High School,345,83,600,1028
11300,Niles Community School District,02767,Northside Child Development Center,43,2,39,84
11300,Niles Community School District,02796,Oak Manor Sixth Grade Center,143,23,119,285
11300,Niles Community School District,03204,Ring Lardner Middle School,270,65,217,552
11300,Niles Community School District,03546,Southside Special Educ School,51,4,16,71
11300,Niles Community School District,05193,James Ellis School,113,15,102,230
11300,Niles Community School District,06635,Cedar Lane School,52,6,32,90
11300,Niles Community School District,08948,Niles Comm. Schools Adult Education,20,0,36,56
11310,Buchanan Community Schools,00435,Buchanan High School,142,43,306,491
11310,Buchanan Community Schools,01528,Stark Elementary School,85,17,100,202
11310,Buchanan Community Schools,02583,Moccasin Elementary School,152,29,115,296
11310,Buchanan Community Schools,05325,Ottawa Elementary School,114,27,133,274
11310,Buchanan Community Schools,06444,Buchanan Middle School,143,32,201,376
11320,Watervliet School District,02722,North Elementary School,154,29,117,300
11320,Watervliet School District,04398,Watervliet Senior High School,146,42,190,378
11320,Watervliet School District,04924,South Elementary School,178,22,118,318
11320,Watervliet School District,08622,Watervliet Middle School,145,29,150,324
11330,Coloma Community Schools,00752,Coloma Elementary School,194,28,169,391
11330,Coloma Community Schools,00753,Coloma High School,156,30,268,454
11330,Coloma Community Schools,00754,Coloma Junior High School,137,28,145,310
11330,Coloma Community Schools,04390,Washington Elementary School,159,31,110,300
11330,Coloma Community Schools,04733,Coloma Middle School,165,42,177,384
11340,Bridgman Public Schools,00400,Bridgman Elementary School,102,37,215,354
11340,Bridgman Public Schools,00401,Bridgman High School,55,33,243,331
11340,Bridgman Public Schools,06196,F.C. Reed Middle School,61,38,201,300
11670,Hagar Township S/D #6,03217,Riverside School,35,5,31,71
11830,Sodus Township S/D #5,05841,River School,32,0,40,72
11901,Countryside Academy,08450,Countryside Academy-High School,113,21,59,193
11901,Countryside Academy,09427,Countryside Academy-Elementary,174,23,48,245
11903,Benton Harbor Charter School,08706,Benton Harbor Charter School,376,6,14,396
11904,Mildred C. Wells Preparatory Academy,09608,Mildred C. Wells Preparatory Academy,172,0,0,172
11905,Dream Academy,09912,Dream Academy,185,8,35,228
12000,Branch ISD,00000,RESA/ISD students attending LEA school--12000,279,0,490,769
12000,Branch ISD,04792,Waldron Learning Center,33,4,15,52
12000,Branch ISD,09176,Dorothy Legg Learning Center,10,2,4,16
12010,Coldwater Community Schools,00744,Coldwater High School,291,75,557,923
12010,Coldwater Community Schools,01080,Larsen Elementary School,211,25,215,451
12010,Coldwater Community Schools,01305,Franklin High School,103,9,38,150
12010,Coldwater Community Schools,01897,Jefferson Elementary School,135,22,186,343
12010,Coldwater Community Schools,02091,Lakeland Elementary School,98,14,133,245
12010,Coldwater Community Schools,02192,Lincoln Elementary School,279,19,44,342
12010,Coldwater Community Schools,05229,Legg Middle School,301,49,355,705
12020,Bronson Community School District,00092,Anderson Elementary School,120,21,82,223
12020,Bronson Community School District,00408,Bronson Jr/Sr High School,268,76,267,611
12020,Bronson Community School District,00409,Chicago Street School,99,21,64,184
12020,Bronson Community School District,03305,Ryan Elementary School,130,29,71,230
12040,Quincy Community School District,01921,Jennings Elementary School,227,59,248,534
12040,Quincy Community School District,03135,Quincy High School,106,25,292,423
12040,Quincy Community School District,05822,Quincy Middle School,152,36,243,431
12901,Pansophia Academy,08250,Pansophia Academy,163,35,57,255
13000,Calhoun ISD,00426,Doris Klaussen Dev. Center,276,22,195,493
13000,Calhoun ISD,05491,Starr Commonwealth for Boys,142,0,14,156
13000,Calhoun ISD,09757,Calhoun County Juvenile Home,30,0,6,36
13010,Albion Public Schools,01581,Harrington Elementary School,335,8,71,414
13010,Albion Public Schools,04366,Washington Gardner Middle School,149,8,43,200
13010,Albion Public Schools,04936,Albion Senior High School,210,10,114,334
13010,Albion Public Schools,09864,Caldwell Elementary,94,2,17,113
13020,Battle Creek Public Schools,00223,Battle Creek Central High School,809,102,430,1341
13020,Battle Creek Public Schools,00738,Coburn School,246,6,23,275
13020,Battle Creek Public Schools,00965,Dudley School,233,14,33,280
13020,Battle Creek Public Schools,01306,Franklin School,322,7,12,341
13020,Battle Creek Public Schools,01326,Fremont School,198,10,105,313
13020,Battle Creek Public Schools,02776,Northwestern Middle School,210,26,52,288
13020,Battle Creek Public Schools,03570,Springfield Middle School,229,24,94,347
13020,Battle Creek Public Schools,04266,Urbandale School,282,21,69,372
13020,Battle Creek Public Schools,04274,Valley View Elementary School,243,37,118,398
13020,Battle Creek Public Schools,04294,Verona Elementary School,318,19,64,401
13020,Battle Creek Public Schools,04320,W.K. Kellogg Middle School,387,20,88,495
13020,Battle Creek Public Schools,07572,Battle Creek Math-Sci Center,5,0,253,258
13020,Battle Creek Public Schools,08574,South Hill Academy,265,6,124,395
13020,Battle Creek Public Schools,08789,Michigan Youth Challenge Academy,25,0,114,139
13020,Battle Creek Public Schools,09351,Ann J. Kellogg School,298,20,69,387
13020,Battle Creek Public Schools,09352,Lamora Park School,158,34,67,259
13050,Athens Area Schools,00136,Athens High School,65,20,120,205
13050,Athens Area Schools,00137,Athens Middle School,85,19,96,200
13050,Athens Area Schools,01027,East Leroy Elementary School,89,22,148,259
13070,Harper Creek Community Schools,00234,Beadle Lake Elementary School,117,16,111,244
13070,Harper Creek Community Schools,01575,Harper Creek Middle School,262,61,461,784
13070,Harper Creek Community Schools,01576,Harper Creek High School,244,39,649,932
13070,Harper Creek Community Schools,03499,Sonoma Elementary,113,31,184,328
13070,Harper Creek Community Schools,04400,Wattles Park Elementary School,99,15,201,315
13080,Homer Community Schools,01748,Homer Community High School,103,28,138,269
13080,Homer Community Schools,02179,Lillian Fletcher Elem. School,215,34,160,409
13080,Homer Community Schools,06811,Homer Middle School,140,35,135,310
13080,Homer Community Schools,07765,Homer Comm. Alt. Education,23,4,13,40
13090,Lakeview Sch. District (Calhoun),02106,Lakeview High School,355,65,952,1372
13090,Lakeview Sch. District (Calhoun),02578,Minges Brook School,137,20,193,350
13090,Lakeview Sch. District (Calhoun),03117,Prairieview School,169,15,64,248
13090,Lakeview Sch. District (Calhoun),03215,Riverside Elementary School,108,18,174,300
13090,Lakeview Sch. District (Calhoun),04483,Westlake Elementary School,88,11,284,383
13090,Lakeview Sch. District (Calhoun),04586,Lakeview Middle School,386,77,719,1182
13095,Mar Lee School District,02366,Mar Lee School,122,23,170,315
13110,Marshall Public Schools,01442,Gordon Elementary School,64,6,168,238
13110,Marshall Public Schools,01790,Hughes Elementary School,68,17,148,233
13110,Marshall Public Schools,02318,Marshall Middle School,173,42,483,698
13110,Marshall Public Schools,06111,Marshall High School,128,44,609,781
13110,Marshall Public Schools,09244,Shearman School EC Programs and Marshall AHS,55,6,25,86
13110,Marshall Public Schools,09245,Walters Elementary,80,13,270,363
13120,Pennfield Schools,02996,Pennfield Dunlap Elementary,156,30,234,420
13120,Pennfield Schools,02997,Pennfield Middle School,182,30,288,500
13120,Pennfield Schools,02998,North Pennfield Elementary,91,5,114,210
13120,Pennfield Schools,02999,Pennfield Purdy School,102,23,122,247
13120,Pennfield Schools,03001,Pennfield Senior High School,198,55,465,718
13130,Tekonsha Community Schools,03010,Tekonsha Elementary School,81,15,51,147
13130,Tekonsha Community Schools,03288,Tekonsha Senior High School,42,12,51,105
13130,Tekonsha Community Schools,07256,Tekonsha Middle School,31,4,19,54
13135,Union City Community Schools,04246,Union City Middle School,156,42,135,333
13135,Union City Community Schools,04247,Union City High School,126,40,203,369
13135,Union City Community Schools,04248,Union City Elementary School,218,44,176,438
13901,Arbor Academy,08615,Arbor Academy,126,14,80,220
13902,Endeavor Charter Academy,08643,Endeavor Charter Academy,300,78,279,657
13903,Marshall Academy,08817,Marshall Academy,65,0,198,263
13904,Battle Creek Area Learning Center,08854,Battle Creek Area Learning Center,96,6,68,170
14000,Lewis Cass ISD,06215,Brookside Learning Center,32,3,13,48
14000,Lewis Cass ISD,09082,North Pointe Center,33,6,15,54
14010,Cassopolis Public Schools,01296,Frank Squires Early Elem. School,156,20,85,261
14010,Cassopolis Public Schools,05995,Ross Beatty High School,263,34,227,524
14010,Cassopolis Public Schools,06658,Sam Adams Elementary School,214,28,106,348
14010,Cassopolis Public Schools,07865,Cassopolis Alternative Ed.,49,0,69,118
14020,Dowagiac Union School District,00608,Dowagiac Middle School,360,67,177,604
14020,Dowagiac Union School District,01983,Justus Gage Elementary School,180,20,91,291
14020,Dowagiac Union School District,02193,Pathfinders Alternative Ed,42,4,25,71
14020,Dowagiac Union School District,02464,Patrick Hamilton Elementary,245,21,71,337
14020,Dowagiac Union School District,03484,Sister Lakes Elementary School,183,11,49,243
14020,Dowagiac Union School District,04253,Union High School,278,59,306,643
14020,Dowagiac Union School District,05140,Kincheloe Elementary School,151,22,129,302
14030,Edwardsburg Public Schools,00995,Eagle Lake Elementary School,129,25,255,409
14030,Edwardsburg Public Schools,01094,Edwardsburg Primary School,158,28,240,426
14030,Edwardsburg Public Schools,01095,Edwardsburg Middle School,182,47,429,658
14030,Edwardsburg Public Schools,01096,Edwardsburg High School,182,49,581,812
14030,Edwardsburg Public Schools,08891,Edwardsburg Intermediate School,129,35,254,418
14050,Marcellus Community Schools,02369,Marcellus Elementary School,169,29,127,325
14050,Marcellus Community Schools,04312,Volinia Outcome Base School,57,9,20,86
14050,Marcellus Community Schools,05257,Marcellus High School,93,25,156,274
14050,Marcellus Community Schools,05562,Marcellus Middle School,121,19,114,254
15000,Charlevoix-Emmet ISD,00000,RESA/ISD students attending LEA school--15000,9,0,0,9
15000,Charlevoix-Emmet ISD,07052,Char-Em Programs,52,12,48,112
15010,Beaver Island Community School,00241,Beaver Island Community School,9,17,45,71
15020,Boyne City Public Schools,00371,Boyne City High School,118,30,229,377
15020,Boyne City Public Schools,00595,Boyne City Elementary School,181,59,220,460
15020,Boyne City Public Schools,06486,Boyne City Middle School,188,54,150,392
15020,Boyne City Public Schools,08257,Great Lakes Academic Center,10,0,17,27
15020,Boyne City Public Schools,08545,Boyne City Alt. Ed. Boyne Valley Campus,15,0,19,34
15030,Boyne Falls Public School District,00372,Boyne Falls Public School,112,25,113,250
15050,Charlevoix Public Schools,00646,Charlevoix High School,69,18,288,375
15050,Charlevoix Public Schools,00647,Charlevoix Middle School,82,27,227,336
15050,Charlevoix Public Schools,05796,Charlevoix Elementary School,126,34,237,397
15050,Charlevoix Public Schools,08936,Beaver Island Lighthouse Program,15,7,8,30
15060,East Jordan Public Schools,01015,East Jordan Elementary School,242,52,206,500
15060,East Jordan Public Schools,01018,East Jordan High School,128,28,186,342
15060,East Jordan Public Schools,07429,East Jordan Middle School,101,35,106,242
15901,Concord Academy Boyne,08290,Concord Academy:Boyne,42,0,162,204
15902,Northwest Academy,00207,Northwest Academy (K),1,0,6,7
15902,Northwest Academy,08340,Northwest Academy,39,12,74,125
16000,Cheb-Otsego-Presque Isle ESD,09024,COP ESD Programs,70,2,47,119
16000,Cheb-Otsego-Presque Isle ESD,09026,Russell House,10,0,0,10
16015,Cheboygan Area Schools,00655,Cheboygan Area High School,274,58,409,741
16015,Cheboygan Area Schools,01007,East Elementary School,208,36,143,387
16015,Cheboygan Area Schools,04445,West Elementary School,154,28,93,275
16015,Cheboygan Area Schools,05776,Cheboygan Middle School,299,58,254,611
16015,Cheboygan Area Schools,07932,Cheboygan Adult Learning Center,39,2,14,55
16050,Inland Lakes Schools,01841,Inland Lakes Elementary School,192,33,147,372
16050,Inland Lakes Schools,01842,Inland Lakes High School,95,28,170,293
16050,Inland Lakes Schools,06761,Inland Lakes Middle School,106,39,134,279
16050,Inland Lakes Schools,09689,Inland Lakes Alternative Education,3,0,5,8
16070,Mackinaw City Public Schools,02306,Mackinaw City K-12 School,42,11,136,189
16100,Wolverine Community Schools,04577,Wolverine Elementary School,108,24,48,180
16100,Wolverine Community Schools,05860,Wolverine Middle/High School,94,20,41,155
17000,Eastern Upper Peninsula ISD,09022,Rudyard Area Service Center,26,2,12,40
17010,Sault Ste. Marie Area Schools,02214,Lincoln School,133,23,142,298
17010,Sault Ste. Marie Area Schools,02264,Sault Area Middle School,173,46,344,563
17010,Sault Ste. Marie Area Schools,03501,Soo Township School,111,22,178,311
17010,Sault Ste. Marie Area Schools,04379,Washington Elementary School,154,34,110,298
17010,Sault Ste. Marie Area Schools,06068,Sault Area High School,239,66,579,884
17010,Sault Ste. Marie Area Schools,06812,Malcolm High School,40,4,32,76
17050,DeTour Area Schools,00905,DeTour High School,32,26,45,103
17050,DeTour Area Schools,00934,DeTour Elementary School,27,6,22,55
17050,DeTour Area Schools,05065,Drummond Island Elem. School,14,10,25,49
17090,Pickford Public Schools,03024,Pickford High School,40,26,109,175
17090,Pickford Public Schools,03025,Pickford Elementary School,95,29,184,308
17090,Pickford Public Schools,09417,Consolidated Community School Services,66,2,49,117
17110,Rudyard Area Schools,05517,Turner-Howson Elementary School,177,40,87,304
17110,Rudyard Area Schools,05631,Rudyard High School,93,24,144,261
17110,Rudyard Area Schools,07814,Rudyard Middle School,170,37,124,331
17140,Brimley Area Schools,00404,Brimley Jr./Sr. High,68,27,143,238
17140,Brimley Area Schools,09119,Brimley Elementary School,103,29,145,277
17160,Whitefish Township Schools,04506,Whitefish Township School,39,4,7,50
17901,Joseph K. Lumsden Bahweting Anishnabe Academy,08063,Joseph K. Lumsden Bahweting Anishnabe Academy,233,58,181,472
17902,Ojibwe Charter School,09308,Ojibwe Charter School,69,8,29,106
18000,Clare-Gladwin Regional Education Service District,00777,Clare-Gladwin Area School,78,11,34,123
18010,Clare Public Schools,00696,Clare Primary School,246,30,267,543
18010,Clare Public Schools,00697,Clare High School,129,40,271,440
18010,Clare Public Schools,06394,Clare Middle School,155,33,242,430
18010,Clare Public Schools,07754,Pioneer High and Clare Adult Ed.,112,2,19,133
18020,Farwell Area Schools,01209,Farwell Elementary School,319,31,173,523
18020,Farwell Area Schools,01210,Farwell High School,222,31,205,458
18020,Farwell Area Schools,06258,Farwell Middle School,292,31,147,470
18020,Farwell Area Schools,09518,Farwell Timberland Alternative High School,38,2,14,54
18060,Harrison Community Schools,01583,Harrison Community High School,295,49,182,526
18060,Harrison Community Schools,05811,Harrison Middle School,266,39,91,396
18060,Harrison Community Schools,06392,Robert M. Larson Elementary School,241,17,99,357
18060,Harrison Community Schools,07812,Harrison Alternative Education,25,0,3,28
18060,Harrison Community Schools,09412,Hillside Elementary School,224,35,88,347
19000,Clinton County RESA,06889,Clinton County Education Center,23,1,45,69
19000,Clinton County RESA,09752,Turning Point Youth Center,10,0,44,54
19010,DeWitt Public Schools,00883,Fuerstenau Early Childhood Center,27,3,207,237
19010,DeWitt Public Schools,00912,DeWitt High School,64,16,845,925
19010,DeWitt Public Schools,03424,Scott Elementary School,43,12,448,503
19010,DeWitt Public Schools,05993,DeWitt Junior High School,47,10,422,479
19010,DeWitt Public Schools,07336,Schavey Road Elementary School,39,14,361,414
19010,DeWitt Public Schools,08806,Herbison Woods Elementary School,36,16,380,432
19070,Fowler Public Schools,01283,Waldron Elementary and Middle School,37,13,299,349
19070,Fowler Public Schools,01284,Fowler High School,9,9,160,178
19100,Bath Community Schools,00218,Bath High School,74,15,236,325
19100,Bath Community Schools,00219,Bath Elementary School,116,25,287,428
19100,Bath Community Schools,04880,Bath Middle School,46,26,143,215
19120,Ovid-Elsie Area Schools,00985,E.E. Knight Elementary School,119,34,186,339
19120,Ovid-Elsie Area Schools,02919,Ovid-Elsie Middle School,94,26,165,285
19120,Ovid-Elsie Area Schools,05073,Leonard Elementary School,200,55,301,556
19120,Ovid-Elsie Area Schools,05333,Ovid-Elsie High School,128,58,377,563
19120,Ovid-Elsie Area Schools,07726,Ovid-Elsie Comm. Ed./Alt. H.S.,35,3,27,65
19125,Pewamo-Westphalia Community Schools,03019,Pewamo Elementary School,39,8,183,230
19125,Pewamo-Westphalia Community Schools,03021,Pewamo-Westphalia Senior High School,13,24,260,297
19125,Pewamo-Westphalia Community Schools,04480,Pewamo-Westphalia Junior High School,17,2,111,130
19140,St. Johns Public Schools,01039,Wilson Center,31,8,37,76
19140,St. Johns Public Schools,01161,Eureka School,43,3,122,168
19140,St. Johns Public Schools,03009,Gateway Elementary School,139,33,153,325
19140,St. Johns Public Schools,03249,St. Johns Middle School,160,43,582,785
19140,St. Johns Public Schools,04115,Oakview Elementary School,125,20,230,375
19140,St. Johns Public Schools,05708,St. Johns High School,170,61,854,1085
19140,St. Johns Public Schools,05709,East Olive Elementary School,13,10,143,166
19140,St. Johns Public Schools,05710,Riley Elementary School,27,19,217,263
20015,Crawford AuSable Schools,01481,Grayling Elementary School,209,35,152,396
20015,Crawford AuSable Schools,01482,Grayling High School,250,67,270,587
20015,Crawford AuSable Schools,06355,Grayling Middle School,192,48,162,402
20015,Crawford AuSable Schools,08381,AuSable Primary School,202,30,137,369
20015,Crawford AuSable Schools,09822,Frederic School,22,2,17,41
21000,Delta-Schoolcraft ISD,03370,Learning Center,46,10,39,95
21010,Escanaba Area Public Schools,01155,Escanaba Area Public High School,270,67,565,902
21010,Escanaba Area Public Schools,01156,Escanaba Middle School,209,64,277,550
21010,Escanaba Area Public Schools,01954,Lemmer Elementary School,207,34,217,458
21010,Escanaba Area Public Schools,03500,Soo Hill Elementary School,78,34,218,330
21010,Escanaba Area Public Schools,04421,Webster Elementary School,160,27,78,265
21010,Escanaba Area Public Schools,05104,Franklin Elementary School,93,18,79,190
21025,Gladstone Area Schools,01407,Gladstone Area Middle School,101,33,223,357
21025,Gladstone Area Schools,01410,Gladstone Area High School,107,40,360,507
21025,Gladstone Area Schools,09333,Cameron Elementary School,122,42,216,380
21025,Gladstone Area Schools,09334,James T. Jones Elementary School,104,44,194,342
21060,Rapid River Public Schools,03151,Tri-Township School,116,26,250,392
21065,Big Bay De Noc School District,06166,Big Bay De Noc School,96,24,128,248
21090,Bark River-Harris School District,00204,Bark River-Harris Jr/Sr High School,93,29,167,289
21090,Bark River-Harris School District,04840,Bark River-Harris Elementary School,142,46,178,366
21135,Mid Peninsula School District,03243,Mid Peninsula School,100,18,115,233
22000,Dickinson-Iron ISD,08877,Dickinson-Iron Special Education,32,9,16,57
22000,Dickinson-Iron ISD,09547,Dickinson Iron Early Childhood Education,3,0,0,3
22010,Iron Mountain Public Schools,00619,Central Elementary School,106,41,161,308
22010,Iron Mountain Public Schools,01978,Central Middle School,60,17,91,168
22010,Iron Mountain Public Schools,03441,Iron Mountain High School,75,35,312,422
22010,Iron Mountain Public Schools,07561,North Elementary School,79,31,151,261
22010,Iron Mountain Public Schools,08831,IM-K Community Education,39,0,89,128
22025,Norway-Vulcan Area Schools,02784,Norway High School,58,28,181,267
22025,Norway-Vulcan Area Schools,09666,Norway Elementary School,86,32,165,283
22025,Norway-Vulcan Area Schools,09667,Vulcan Middle School,65,28,154,247
22030,Breitung Township Schools,02039,Kingsford High School,101,65,454,620
22030,Breitung Township Schools,02040,Kingsford Middle School,88,59,229,376
22030,Breitung Township Schools,07358,Woodland Elementary School,249,62,410,721
22045,North Dickinson County Schools,06194,North Dickinson School,86,73,167,326
23000,Eaton ISD,07286,Meadowview School,9,0,24,33
23000,Eaton ISD,09236,Meadowview Offsite -CLC,40,0,69,109
23010,Bellevue Community Schools,00265,Bellevue Elementary School,162,32,147,341
23010,Bellevue Community Schools,00267,Bellevue Jr/Sr High School,121,22,184,327
23030,Charlotte Public Schools,00648,Charlotte Senior High School,223,76,607,906
23030,Charlotte Public Schools,00649,Charlotte Middle School,320,82,561,963
23030,Charlotte Public Schools,01353,Galewood Elementary School,99,29,106,234
23030,Charlotte Public Schools,04386,Washington Elementary School,152,35,212,399
23030,Charlotte Public Schools,05797,Parkview Elementary School,133,31,281,445
23030,Charlotte Public Schools,07757,Charlotte Alternative Education,42,9,74,125
23030,Charlotte Public Schools,09959,Weymouth Child Development Center,13,2,11,26
23050,Eaton Rapids Public Schools,01060,Eaton Rapids Senior High School,246,98,641,985
23050,Eaton Rapids Public Schools,02779,Northwestern Elementary School,163,34,186,383
23050,Eaton Rapids Public Schools,06026,Lockwood Elementary School,158,28,182,368
23050,Eaton Rapids Public Schools,06202,Eaton Rapids Middle School,154,39,261,454
23050,Eaton Rapids Public Schools,07672,Greyhound Central,52,3,38,93
23050,Eaton Rapids Public Schools,08488,Greyhound Intermediate School,194,57,323,574
23060,Grand Ledge Public Schools,00483,C.W. Neff Elementary School,73,22,352,447
23060,Grand Ledge Public Schools,00898,Delta Center Elementary School,86,21,413,520
23060,Grand Ledge Public Schools,01058,Kenneth T. Beagle Middle School,113,31,352,496
23060,Grand Ledge Public Schools,01457,Grand Ledge High School,263,96,1300,1659
23060,Grand Ledge Public Schools,01500,Greenwood Elementary School,90,19,167,276
23060,Grand Ledge Public Schools,04122,T.C. Holbrook Elementary School,102,22,142,266
23060,Grand Ledge Public Schools,04323,Wacousta Elementary School,44,20,271,335
23060,Grand Ledge Public Schools,05818,Leon W. Hayes Middle School,106,54,534,694
23060,Grand Ledge Public Schools,08351,Willow Ridge Elementary School,86,25,378,489
23060,Grand Ledge Public Schools,08979,Sawdon High School,44,3,56,103
23065,Maple Valley Schools,01339,Fuller Street Elementary School,205,32,144,381
23065,Maple Valley Schools,02354,Maple Valley Jr/Sr High School,217,37,395,649
23065,Maple Valley Schools,02359,Maplewood School,124,24,143,291
23065,Maple Valley Schools,07776,Kellogg Education Center,61,2,15,78
23080,Olivet Community Schools,01221,Fern Persons Elementary School,152,22,265,439
23080,Olivet Community Schools,02828,Olivet High School,117,40,334,491
23080,Olivet Community Schools,06354,Olivet Middle School,194,42,346,582
23090,Potterville Public Schools,02170,Potterville Elementary School,126,37,210,373
23090,Potterville Public Schools,03112,Potterville High School,67,21,155,243
23090,Potterville Public Schools,07894,CAP Adult and Alternative Education,42,2,16,60
23090,Potterville Public Schools,09073,Potterville Middle School,87,25,162,274
23490,Oneida Township S/D #3,05627,Strange School,2,0,21,23
23901,Island City Academy,08322,Island City Academy,43,33,128,204
24020,Harbor Springs School District,01564,Harbor Springs High School,56,26,246,328
24020,Harbor Springs School District,01566,Shay Elementary School,68,14,141,223
24020,Harbor Springs School District,07547,Harbor Springs Middle School,68,14,167,249
24020,Harbor Springs School District,07741,Blackbird Elementary School,46,14,164,224
24030,Alanson Public Schools,02241,Alanson Public School,172,51,111,334
24040,Pellston Public Schools,02993,Pellston Elementary School,164,32,104,300
24040,Pellston Public Schools,02994,Pellston Middle/High School,135,52,197,384
24070,Public Schools of Petoskey,00623,Central Elementary School,74,16,185,275
24070,Public Schools of Petoskey,02220,Lincoln School,81,18,169,268
24070,Public Schools of Petoskey,02867,Ottawa Elementary School,144,26,188,358
24070,Public Schools of Petoskey,03017,Petoskey High School,219,83,739,1041
24070,Public Schools of Petoskey,03018,Petoskey Middle School,182,62,449,693
24070,Public Schools of Petoskey,03463,Sheridan School,104,29,143,276
24070,Public Schools of Petoskey,08492,Petoskey Montessori Elem. School,1,0,31,32
24901,Concord Academy - Petoskey,08210,Concord Academy-Petoskey,79,22,219,320
25000,Genesee ISD,02658,Special Education Services-South,95,0,140,235
25000,Genesee ISD,03691,Marion D. Crouse Instr. Center,67,2,129,198
25000,Genesee ISD,06156,Elmer A. Knopf Learning Center,155,10,281,446
25000,Genesee ISD,09725,Special Services - North,10,2,8,20
25000,Genesee ISD,09765,Genesee ISD Transition Center,48,3,47,98
25010,Flint City School District,00425,Brownell School,303,6,82,391
25010,Flint City School District,00530,Carpenter Road School,264,0,17,281
25010,Flint City School District,00789,Coolidge School,288,13,67,368
25010,Flint City School District,00938,Dort School,368,1,69,438
25010,Flint City School District,00974,Durant Tuuri Mott School,431,24,45,500
25010,Flint City School District,01098,Eisenhower School,314,20,41,375
25010,Flint City School District,01320,Freeman School,271,3,29,303
25010,Flint City School District,02670,Neithercut Elementary School,271,19,60,350
25010,Flint City School District,02777,Northwestern High School,741,12,374,1127
25010,Flint City School District,03033,Pierce School,219,10,135,364
25010,Flint City School District,03108,Potter School,346,16,18,380
25010,Flint City School District,03129,Doyle/Ryder School,316,17,61,394
25010,Flint City School District,03423,Scott School,391,5,39,435
25010,Flint City School District,03554,Southwestern Academy,382,23,340,745
25010,Flint City School District,04387,Washington School,355,5,56,416
25010,Flint City School District,04520,Classical Academy,99,9,145,253
25010,Flint City School District,04995,Bunche School,372,3,66,441
25010,Flint City School District,05699,Williams School,228,2,11,241
25010,Flint City School District,05949,Summerfield School,267,8,38,313
25010,Flint City School District,05950,Zimmerman Center,385,0,275,660
25010,Flint City School District,06015,Schools of Choice,285,7,138,430
25010,Flint City School District,06199,Northern High School,827,11,450,1288
25010,Flint City School District,06260,Wilkins School,190,3,12,205
25010,Flint City School District,07576,Mott Middle College High School,233,31,156,420
25010,Flint City School District,09081,Bryant Elementary School,343,3,17,363
25010,Flint City School District,09347,Manley Early Childhood Education Center,10,0,2,12
25010,Flint City School District,09622,King Early Childhood Education Center,11,0,0,11
25010,Flint City School District,09774,Genesee Early College,52,0,99,151
25010,Flint City School District,09891,Holmes Foundation,471,6,83,560
25010,Flint City School District,09892,McKinley Foundation,505,15,81,601
25030,Grand Blanc Community Schools,01452,Perry Kindergarten,36,5,130,171
25030,Grand Blanc Community Schools,01453,Grand Blanc Community High School,487,122,2061,2670
25030,Grand Blanc Community Schools,01833,Indian Hill Elementary School,80,16,372,468
25030,Grand Blanc Community Schools,02654,Myers Elementary School,77,21,462,560
25030,Grand Blanc Community Schools,05599,Cook Elementary School,77,13,362,452
25030,Grand Blanc Community Schools,05677,McGrath Elementary School,168,34,213,415
25030,Grand Blanc Community Schools,07364,Reid Elementary School,78,40,421,539
25030,Grand Blanc Community Schools,08375,Anderson Elementary School,174,23,210,407
25030,Grand Blanc Community Schools,08963,City School,7,1,110,118
25030,Grand Blanc Community Schools,09157,Lillian G. Mason Elementary School,75,22,378,475
25030,Grand Blanc Community Schools,09382,Grand Blanc Middle School East,138,33,824,995
25030,Grand Blanc Community Schools,09383,Grand Blanc Middle School West,276,61,625,962
25030,Grand Blanc Community Schools,09665,Brendel Elementary School,148,27,288,463
25040,Mt. Morris Consolidated Schools,01863,Moore Elementary School,215,33,68,316
25040,Mt. Morris Consolidated Schools,02595,Montague Elementary School,230,23,72,325
25040,Mt. Morris Consolidated Schools,02633,Mt. Morris Junior High School,364,57,127,548
25040,Mt. Morris Consolidated Schools,03053,Pinehurst Elementary School,261,29,63,353
25040,Mt. Morris Consolidated Schools,05763,E.A. Johnson Memorial H.S.,396,73,269,738
25040,Mt. Morris Consolidated Schools,07691,Mt. Morris Alternative Ed.,453,6,277,736
25050,Goodrich Area Schools,01441,Goodrich High School,77,23,630,730
25050,Goodrich Area Schools,03179,Reid Elementary School,65,10,362,437
25050,Goodrich Area Schools,05994,Goodrich Middle School,56,18,457,531
25050,Goodrich Area Schools,08352,Oaktree Elementary School,63,25,406,494
25060,Bendle Public Schools,00270,Bendle High School,241,31,104,376
25060,Bendle Public Schools,03503,South Bendle Elementary School,221,16,53,290
25060,Bendle Public Schools,04124,Bendle Middle School,226,17,47,290
25060,Bendle Public Schools,04435,West Bendle Elementary School,192,17,47,256
25060,Bendle Public Schools,07710,Bendle/Carman-Ainsworth Alternative Education,261,5,218,484
25070,Genesee School District,01378,Genesee High School,208,43,193,444
25070,Genesee School District,01867,Haas Elementary School,201,23,99,323
25080,Carman-Ainsworth Community Schools,00031,Carman-Ainsworth Middle School,625,108,396,1129
25080,Carman-Ainsworth Community Schools,00980,Dye Elementary School,299,42,136,477
25080,Carman-Ainsworth Community Schools,01414,Gladys Dillon Elementary School,193,36,81,310
25080,Carman-Ainsworth Community Schools,03147,Randels Elementary School,281,48,200,529
25080,Carman-Ainsworth Community Schools,03149,Rankin Elementary School,212,34,135,381
25080,Carman-Ainsworth Community Schools,04583,Woodland Elementary School,233,25,58,316
25080,Carman-Ainsworth Community Schools,05009,Carman-Ainsworth High School,716,141,754,1611
25100,Fenton Area Public Schools,01041,Tomek-Eastern Elem. School,120,27,345,492
25100,Fenton Area Public Schools,01219,Andrew G. Schmidt Middle School,180,50,559,789
25100,Fenton Area Public Schools,02744,North Road Elementary School,124,37,375,536
25100,Fenton Area Public Schools,04059,State Road Elementary School,71,28,376,475
25100,Fenton Area Public Schools,05690,Fenton Senior High School,224,62,961,1247
25110,Kearsley Community Schools,00441,Thelma Buffey Elementary School,184,10,129,323
25110,Kearsley Community Schools,00949,Kate Dowdall Elementary School,127,19,145,291
25110,Kearsley Community Schools,01230,Leota Fiedler Elementary School,114,24,159,297
25110,Kearsley Community Schools,01993,Kearsley High School,450,94,704,1248
25110,Kearsley Community Schools,04486,Weston Elementary School,194,19,229,442
25110,Kearsley Community Schools,06282,Armstrong Middle School,319,79,397,795
25120,Flushing Community Schools,00585,Central Elementary School,118,42,354,514
25120,Flushing Community Schools,01125,Elms Elementary School,148,25,267,440
25120,Flushing Community Schools,01256,Flushing High School,323,78,1177,1578
25120,Flushing Community Schools,01257,Flushing Middle School,170,44,434,648
25120,Flushing Community Schools,03446,Seymour Elementary School,99,23,388,510
25120,Flushing Community Schools,03575,Springview Elementary School,128,15,218,361
25120,Flushing Community Schools,09652,Flushing Early Childhood Center,65,12,245,322
25130,Atherton Community Schools,00138,Atherton High School,174,37,121,332
25130,Atherton Community Schools,00139,Atherton Middle School,206,42,115,363
25130,Atherton Community Schools,04275,Vern Van Y. School,165,40,78,283
25140,Davison Community Schools,00878,Davison High School,327,68,1203,1598
25140,Davison Community Schools,00879,Davison Middle School,215,73,567,855
25140,Davison Community Schools,01674,Hill Elementary School,54,20,202,276
25140,Davison Community Schools,02728,Siple Elementary School,140,48,195,383
25140,Davison Community Schools,03511,Gates Elementary School,193,38,344,575
25140,Davison Community Schools,04174,Thomson Elementary School,141,26,221,388
25140,Davison Community Schools,06315,Central Elementary School,166,41,292,499
25140,Davison Community Schools,07770,Davison Alternative Education,95,18,56,169
25140,Davison Community Schools,08619,Hahn Intermediate School,291,57,516,864
25150,Clio Area School District,00002,A.C. Edgerton Elementary School,134,28,257,419
25150,Clio Area School District,00732,Clio Area High School,303,73,654,1030
25150,Clio Area School District,00733,Clio Community Education,63,5,66,134
25150,Clio Area School District,01383,George A. Lacure Elem. School,159,39,227,425
25150,Clio Area School District,01391,George R. Carter Middle School,372,81,574,1027
25150,Clio Area School District,01416,Glen Garner Elementary School,201,33,203,437
25180,Swartz Creek Community Schools,01349,Gaines Elementary School,73,18,153,244
25180,Swartz Creek Community Schools,02617,Morrish Elementary School,113,26,332,471
25180,Swartz Creek Community Schools,04110,Swartz Creek Middle School,299,63,590,952
25180,Swartz Creek Community Schools,04111,Swartz Creek High School,254,68,887,1209
25180,Swartz Creek Community Schools,04121,Syring Elementary School,75,21,202,298
25180,Swartz Creek Community Schools,05768,Elms Road Elementary School,153,30,220,403
25180,Swartz Creek Community Schools,05769,Dieck Elementary School,133,21,163,317
25180,Swartz Creek Community Schools,07465,Swartz Creek Academy,59,5,53,117
25200,Lake Fenton Community Schools,02082,Lake Fenton High School,111,33,396,540
25200,Lake Fenton Community Schools,05779,West Shore Elementary School,98,15,338,451
25200,Lake Fenton Community Schools,06190,Torrey Hill Intermediate School,100,20,283,403
25200,Lake Fenton Community Schools,09550,Lake Fenton Middle School,84,32,306,422
25210,Westwood Heights Schools,01543,Hamady Middle School,153,8,24,185
25210,Westwood Heights Schools,05928,Colonel Donald McMonagle Elementary School,424,18,42,484
25210,Westwood Heights Schools,06235,Hamady Community High School,235,14,76,325
25230,Bentley Community Schools,00203,Barhitte Elementary School,198,48,181,427
25230,Bentley Community Schools,00284,Bentley Senior High School,215,44,214,473
25240,Beecher Community School District,00253,Beecher High School,328,16,89,433
25240,Beecher Community School District,00439,Tucker Elementary School,369,7,21,397
25240,Beecher Community School District,00862,Dailey Elementary School,434,3,34,471
25240,Beecher Community School District,02052,Beecher Adult/Alternative Education Center,121,1,63,185
25240,Beecher Community School District,05687,Beecher Middle School Academy,207,3,21,231
25250,Linden Community Schools,00118,Argentine Elementary School,0,0,8,8
25250,Linden Community Schools,02230,Linden Elementary School,88,21,341,450
25250,Linden Community Schools,02231,Linden High School,166,36,700,902
25250,Linden Community Schools,02232,Linden Middle School,174,33,525,732
25250,Linden Community Schools,04822,Central Elementary School,107,31,264,402
25250,Linden Community Schools,09359,Hyatt Elementary,142,30,389,561
25260,Montrose Community Schools,00543,Carter Elementary School,246,47,232,525
25260,Montrose Community Schools,01671,Hill-McCloy High School,165,45,257,467
25260,Montrose Community Schools,06956,Kuehn-Haven Middle School,200,63,197,460
25260,Montrose Community Schools,09494,Montrose Alternative Education Center,46,4,27,77
25280,LakeVille Community Schools,00759,Columbiaville Elementary School,158,45,150,353
25280,LakeVille Community Schools,02111,LakeVille High School,178,53,336,567
25280,LakeVille Community Schools,02862,LakeVille Middle School,151,51,188,390
25280,LakeVille Community Schools,02871,Otter Lake Elementary School,106,24,75,205
25280,LakeVille Community Schools,08058,LakeVille Alternative High School,42,9,31,82
25280,LakeVille Community Schools,09967,Otisville Elementary School,61,12,50,123
25902,Woodland Park Academy,04074,Woodland Park Academy,217,45,160,422
25903,Grand Blanc Academy,08705,Grand Blanc Academy,312,13,146,471
25904,Northridge Academy,08721,Northridge Academy,258,1,5,264
25905,International Academy of Flint,08732,International Academy of Flint (K-12),884,81,215,1180
25906,Center Academy,08731,Center Academy,447,30,22,499
25907,Linden Charter Academy,08739,Linden Charter Academy,609,64,99,772
25908,Academy of Flint,08738,Academy of Flint,521,22,21,564
25909,Burton Glen Charter Academy,08766,Burton Glen Charter Academy,545,71,153,769
25910,Richfield Public School Academy,09305,Richfield Public School Academy,490,29,84,603
25911,Madison Academy,09450,Madison Academy,267,41,209,517
26010,Beaverton Rural Schools,00243,Beaverton Primary School,212,32,133,377
26010,Beaverton Rural Schools,00244,Beaverton High School,174,31,252,457
26010,Beaverton Rural Schools,04826,Beaverton Middle School,255,44,239,538
26040,Gladwin Community Schools,01411,Gladwin Junior High School,200,42,172,414
26040,Gladwin Community Schools,01412,Gladwin Elementary School,218,28,135,381
26040,Gladwin Community Schools,01413,Gladwin Intermediate School,211,40,178,429
26040,Gladwin Community Schools,07249,Gladwin High School,252,49,303,604
26040,Gladwin Community Schools,07898,Gladwin Community Alternative H.S.,32,2,15,49
26901,Creative Learning Academy of Science,08341,Creative Learning Academy of Science,50,0,14,64
27000,Gogebic-Ontonagon ISD,08902,Gogebic-Ontonagon ISD Special Education,34,1,6,41
27010,Bessemer Area School District,00003,A.D. Johnston Jr/Sr High School,90,30,123,243
27010,Bessemer Area School District,04360,Washington School,86,20,106,212
27020,Ironwood Area Schools,02282,Luther L. Wright High School,225,57,261,543
27020,Ironwood Area Schools,02711,Norrie Elementary School,112,16,79,207
27020,Ironwood Area Schools,03489,Sleight Elementary School,120,11,67,198
27020,Ironwood Area Schools,09008,Gogebic Co. Community Education,35,0,12,47
27070,Wakefield-Marenisco School District,04329,Wakefield-Marenisco School,107,44,130,281
27080,Watersmeet Township School District,04397,Watersmeet Township School,74,43,53,170
28000,Traverse Bay Area ISD,07133,New Campus Center,47,7,7,61
28000,Traverse Bay Area ISD,07492,Adult Work Center,99,4,30,133
28000,Traverse Bay Area ISD,09503,TBA Early Childhood,4,0,6,10
28000,Traverse Bay Area ISD,09748,TBA ISD Oak Park Special Education,16,4,36,56
28000,Traverse Bay Area ISD,09783,TBA ISD Traverse Heights,49,8,45,102
28010,Traverse City Area Public Schools,00599,Central Grade School,206,50,336,592
28010,Traverse City Area Public Schools,00661,Cherry Knoll Elementary School,150,35,178,363
28010,Traverse City Area Public Schools,01040,Eastern Elementary School,41,15,174,230
28010,Traverse City Area Public Schools,01844,Interlochen Elementary School,122,51,123,296
28010,Traverse City Area Public Schools,02250,Long Lake Elementary School,110,27,162,299
28010,Traverse City Area Public Schools,02823,Old Mission Peninsula School,38,15,149,202
28010,Traverse City Area Public Schools,04199,West Middle School,321,109,782,1212
28010,Traverse City Area Public Schools,04200,Central High School,352,89,1071,1512
28010,Traverse City Area Public Schools,04201,Traverse Heights Elem. School,214,17,38,269
28010,Traverse City Area Public Schools,04549,Willow Hill Elementary School,96,30,307,433
28010,Traverse City Area Public Schools,07206,Silver Lake Elementary School,88,36,150,274
28010,Traverse City Area Public Schools,07461,Blair Elementary School,199,41,69,309
28010,Traverse City Area Public Schools,07462,Westwoods Elementary School,57,27,272,356
28010,Traverse City Area Public Schools,07573,Courtade Elementary School,132,21,238,391
28010,Traverse City Area Public Schools,07724,East Middle School,302,76,582,960
28010,Traverse City Area Public Schools,08470,West Senior High,407,165,1260,1832
28010,Traverse City Area Public Schools,08810,Traverse City High School,116,13,57,186
28010,Traverse City Area Public Schools,09381,TCAPS Montessori School,61,24,248,333
28035,Buckley Community School District,00438,Buckley Community Schools,199,46,151,396
28090,Kingsley Area Schools,02041,Kingsley Area High School,141,51,297,489
28090,Kingsley Area Schools,05896,Kingsley Area Elementary School,226,40,267,533
28090,Kingsley Area Schools,07453,Kingsley Area Middle School,190,47,248,485
28901,Woodland School,08342,Woodland School,33,0,174,207
28902,Grand Traverse Academy,08703,Grand Traverse Academy,270,54,787,1111
28903,Traverse City College Preparatory Academy,09821,Traverse City College Preparatory Academy,21,1,49,71
29000,Gratiot-Isabella RESD,06883,RESD Isabella County,38,0,25,63
29000,Gratiot-Isabella RESD,07502,RESD Gratiot County,66,0,60,126
29010,Alma Public Schools,01676,Hillcrest Elementary School,196,26,135,357
29010,Alma Public Schools,03042,Pine Avenue Elementary School,149,19,134,302
29010,Alma Public Schools,05774,Alma Senior High School,201,43,416,660
29010,Alma Public Schools,05801,Alma Middle School,209,45,247,501
29010,Alma Public Schools,07242,Alma Adult/Alternative Education,57,4,43,104
29010,Alma Public Schools,07367,Luce Road Elementary School,199,31,136,366
29020,Ashley Community Schools,00131,Ashley High School,57,12,75,144
29020,Ashley Community Schools,04955,Ashley Elementary School,62,13,62,137
29020,Ashley Community Schools,09698,Ashley Middle School,39,11,52,102
29040,Breckenridge Community Schools,00388,Breckenridge High School,80,14,153,247
29040,Breckenridge Community Schools,05083,Breckenridge Elementary School,179,26,184,389
29040,Breckenridge Community Schools,05542,Breckenridge Middle School,74,13,111,198
29040,Breckenridge Community Schools,07412,A.I.M.,19,0,9,28
29050,Fulton Schools,01342,Fulton High School,51,18,147,216
29050,Fulton Schools,06595,Fulton Elementary School,149,27,201,377
29050,Fulton Schools,08281,Fulton Middle School,35,9,74,118
29050,Fulton Schools,09005,Fulton Alternative Education,174,7,121,302
29060,Ithaca Public Schools,01859,Ithaca High School,217,32,384,633
29060,Ithaca Public Schools,02727,North Elementary School,136,42,240,418
29060,Ithaca Public Schools,03509,South Elementary School,135,24,140,299
29100,St. Louis Public Schools,00535,Carrie Knause Early Childhood Learning Center,150,0,115,265
29100,St. Louis Public Schools,03842,St. Louis High School,137,0,235,372
29100,St. Louis Public Schools,05688,Eugene M. Nikkari Elementary,150,0,133,283
29100,St. Louis Public Schools,05689,T.S. Nurnberger Middle School,126,0,169,295
30000,Hillsdale ISD,00000,RESA/ISD students attending LEA school--30000,8,0,0,8
30000,Hillsdale ISD,00737,Greenfield School,49,5,23,77
30000,Hillsdale ISD,09169,The Manor,4,0,102,106
30000,Hillsdale ISD,09428,Lochaven Center For Community Advancement,3,0,1,4
30010,Camden-Frontier Schools,00504,Camden-Frontier High School,41,21,93,155
30010,Camden-Frontier Schools,00505,Camden-Frontier Elem. School,131,38,129,298
30010,Camden-Frontier Schools,08498,Camden-Frontier Middle School,54,17,46,117
30020,Hillsdale Community Schools,00171,Bailey Elementary School,145,31,81,257
30020,Hillsdale Community Schools,00876,Davis Middle School,210,40,141,391
30020,Hillsdale Community Schools,01399,Gier Elementary School,233,40,136,409
30020,Hillsdale Community Schools,01685,Hillsdale High School,196,36,258,490
30020,Hillsdale Community Schools,02440,Mauck Elementary School,84,8,46,138
30020,Hillsdale Community Schools,09820,Horizon Alternative School,64,6,19,89
30030,Jonesville Community Schools,01973,Jonesville High School,124,24,216,364
30030,Jonesville Community Schools,04542,Williams Elementary School,336,72,297,705
30030,Jonesville Community Schools,04696,Jonesville Alternative H.S.,56,6,20,82
30030,Jonesville Community Schools,08885,Jonesville Middle School,110,30,137,277
30040,Litchfield Community Schools,02237,Litchfield High School,106,35,71,212
30040,Litchfield Community Schools,02238,Litchfield Elementary School,78,19,34,131
30050,North Adams-Jerome Schools,02714,North Adams High School,90,19,128,237
30050,North Adams-Jerome Schools,02715,North Adams-Jerome Elem. School,103,23,104,230
30060,Pittsford Area Schools,03061,Pittsford Area High School,115,36,189,340
30060,Pittsford Area Schools,03062,Pittsford Area Elem. School,131,36,153,320
30070,Reading Community Schools,03159,Reading High School,191,37,215,443
30070,Reading Community Schools,03188,Reynolds Elementary School,250,36,166,452
30080,Waldron Area Schools,04330,Waldron Elementary School,86,10,43,139
30080,Waldron Area Schools,04331,Waldron High School,62,9,50,121
30080,Waldron Area Schools,08826,Waldron Middle School,49,6,23,78
30901,Hillsdale Preparatory School,08482,Hillsdale Preparatory School,46,21,4,71
30902,Will Carleton Charter School Academy,08601,Will Carleton Charter School Academy,35,0,225,260
31000,Copper Country ISD,03822,Copper Country Learning Center,44,1,44,89
31000,Copper Country ISD,08565,Keweenaw Academy,1,0,0,1
31010,Hancock Public Schools,01555,Hancock Central High School,74,34,138,246
31010,Hancock Public Schools,07366,Barkell Elementary School,119,87,210,416
31010,Hancock Public Schools,08744,Hancock Middle School,62,27,108,197
31020,Adams Township School District,01893,Jeffers High School,54,41,109,204
31020,Adams Township School District,03527,South Range Elementary School,90,35,121,246
31030,Public Schools of Calumet,00497,Calumet High School,149,50,216,415
31030,Public Schools of Calumet,02293,C.L.K. Elementary School,387,97,234,718
31030,Public Schools of Calumet,04357,Washington Middle School,155,64,145,364
31030,Public Schools of Calumet,09566,CHS-Horizons School,46,3,11,60
31050,Chassell Township School District,00652,Chassell K-12 School,108,34,128,270
31070,Elm River Township School District,01120,Elm River Township School,9,0,7,16
31100,Dollar Bay-Tamarack City Area Schools,00927,Dollar Bay High School,49,17,75,141
31100,Dollar Bay-Tamarack City Area Schools,06189,T.R. Davis Elementary School,73,32,52,157
31110,Houghton-Portage Township Schools,01766,Houghton Central High School,60,35,328,423
31110,Houghton-Portage Township Schools,06411,Houghton Elementary School,136,36,409,581
31110,Houghton-Portage Township Schools,08558,Houghton Middle School,68,29,205,302
31130,Lake Linden-Hubbell School District,02080,Lake Linden-Hubbell Elem. School,109,27,126,262
31130,Lake Linden-Hubbell School District,02083,Lake Linden-Hubbell High School,75,33,137,245
31140,Stanton Township Public Schools,06401,E.B. Holman Elementary School,61,37,44,142
32000,Huron ISD,07287,Huron Learning Center,52,8,50,110
32010,Bad Axe Public Schools,00164,George E. Greene Elem. School,108,14,149,271
32010,Bad Axe Public Schools,00165,Bad Axe High School,122,43,282,447
32010,Bad Axe Public Schools,00166,Bad Axe Junior High School,97,31,144,272
32010,Bad Axe Public Schools,06390,Bad Axe Intermediate School,93,21,143,257
32030,Caseville Public Schools,00551,Caseville High School,37,6,44,87
32030,Caseville Public Schools,06050,Caseville Elementary School,66,9,44,119
32030,Caseville Public Schools,09751,Caseville Middle School,29,6,26,61
32040,Church School District,00690,Church School,12,2,12,26
32050,Elkton-Pigeon-Bay Port Laker Schools,01109,Laker High School,99,52,195,346
32050,Elkton-Pigeon-Bay Port Laker Schools,02093,Laker Junior High School,77,28,124,229
32050,Elkton-Pigeon-Bay Port Laker Schools,09023,Laker Elementary,185,40,179,404
32060,Harbor Beach Community Schools,01563,Harbor Beach Community High School,99,43,138,280
32060,Harbor Beach Community Schools,06115,Harbor Beach Elementary School,57,21,57,135
32060,Harbor Beach Community Schools,08487,Harbor Beach Middle School,65,19,80,164
32080,North Huron School District,02733,North Huron Elementary School,101,22,64,187
32080,North Huron School District,02734,North Huron Secondary School,102,34,112,248
32090,Owendale-Gagetown Area Schools,05109,Owendale-Gagetown Elementary School,56,13,20,89
32090,Owendale-Gagetown Area Schools,05605,Owendale-Gagetown Jr/Sr High School,60,20,48,128
32130,Port Hope Community Schools,03080,Port Hope Community School,44,11,27,82
32170,Ubly Community Schools,04243,Ubly Community Elementary School,198,83,255,536
32170,Ubly Community Schools,05854,Ubly Community High School,85,35,149,269
32260,Colfax Township S/D #1F,00319,Big Burning School,18,0,6,24
32610,Sigel Township S/D #3F,05411,Adams Elementary School,5,3,10,18
32620,Sigel Township S/D #4F,01066,Eccles School,9,0,7,16
32630,Sigel Township S/D #6,02050,Kipper School,2,1,8,11
32650,Verona Township S/D #1F,04293,Verona Mills School,8,0,15,23
33000,Ingham ISD,06962,Heartwood School,27,0,98,125
33000,Ingham ISD,07742,Malcolm Williams School,15,0,19,34
33000,Ingham ISD,07743,SLC/Evergreen,13,0,32,45
33000,Ingham ISD,08755,St. Vincent Home,5,0,22,27
33000,Ingham ISD,08847,Ingham Administrative Unit,1,0,18,19
33010,East Lansing School District,01025,East Lansing High School,260,65,816,1141
33010,East Lansing School District,01418,Glencairn School,50,8,162,220
33010,East Lansing School District,03052,Pinecrest School,90,15,256,361
33010,East Lansing School District,03160,Red Cedar School,87,19,132,238
33010,East Lansing School District,04511,Whitehills Elementary School,77,14,178,269
33010,East Lansing School District,05416,Marble School,60,6,292,358
33010,East Lansing School District,05554,Donley Elementary School,128,16,169,313
33010,East Lansing School District,05798,MacDonald Middle School,138,31,364,533
33020,Lansing Public School District,00144,Attwood School,187,17,73,277
33020,Lansing Public School District,00177,English Language Acquisition Center,193,1,1,195
33020,Lansing Public School District,00326,Bingham School,257,10,10,277
33020,Lansing Public School District,00484,C.W. Otto Middle School,484,43,79,606
33020,Lansing Public School District,00561,Cavanaugh School,185,20,44,249
33020,Lansing Public School District,00849,Cumberland School,214,27,81,322
33020,Lansing Public School District,01044,Eastern High School,885,98,409,1392
33020,Lansing Public School District,01122,Elmhurst School,166,19,70,255
33020,Lansing Public School District,01166,Everett High School,902,127,463,1492
33020,Lansing Public School District,01195,Fairview School,168,15,92,275
33020,Lansing Public School District,01269,Forest View School,253,23,62,338
33020,Lansing Public School District,01270,Forrest G. Averill School,169,25,49,243
33020,Lansing Public School District,01400,Gier Park School,265,27,26,318
33020,Lansing Public School District,01641,Pattengill Middle School,552,52,138,742
33020,Lansing Public School District,01865,J.W. Sexton High School,482,56,262,800
33020,Lansing Public School District,02013,Kendon School,156,18,50,224
33020,Lansing Public School District,02175,Lewton School,192,13,64,269
33020,Lansing Public School District,02290,Lyons School,212,17,74,303
33020,Lansing Public School District,02625,Mt. Hope School,224,26,49,299
33020,Lansing Public School District,03072,Pleasant View Magnet School,317,55,184,556
33020,Lansing Public School District,03107,Post Oak School,241,53,152,446
33020,Lansing Public School District,03181,Reo School,244,9,13,266
33020,Lansing Public School District,03462,Sheridan Road School,255,27,55,337
33020,Lansing Public School District,04328,Wainwright School,263,20,25,308
33020,Lansing Public School District,04456,Education Options,270,16,130,416
33020,Lansing Public School District,04551,Willow School,233,10,17,260
33020,Lansing Public School District,04650,Wexford Montessori Magnet School,230,34,98,362
33020,Lansing Public School District,05068,Dwight Rich Middle School,402,46,118,566
33020,Lansing Public School District,05148,Hill Center,2,0,3,5
33020,Lansing Public School District,05261,Beekman Center,115,14,68,197
33020,Lansing Public School District,05560,Woodcreek Magnet School,176,25,42,243
33020,Lansing Public School District,05696,Gardner Middle School,559,61,164,784
33020,Lansing Public School District,06662,North School,321,25,55,401
33020,Lansing Public School District,09564,Riddle Elementary,130,7,8,145
33020,Lansing Public School District,09834,Harley Franks Early Childhood Center,51,1,17,69
33040,Dansville Schools,00870,Dansville Elementary School,114,21,252,387
33040,Dansville Schools,00871,Dansville High School,59,14,230,303
33040,Dansville Schools,06492,Dansville Middle School,45,9,163,217
33060,Haslett Public Schools,01530,Murphy Elementary School,65,8,301,374
33060,Haslett Public Schools,01604,Haslett Middle School,90,21,527,638
33060,Haslett Public Schools,04288,Vera Ralya Elementary School,82,13,295,390
33060,Haslett Public Schools,04529,Wilkshire School,75,7,334,416
33060,Haslett Public Schools,06207,Haslett High School,108,19,782,909
33070,Holt Public Schools,00918,Dimondale Elementary School,104,0,191,295
33070,Holt Public Schools,01112,Elliott Elementary School,163,0,182,345
33070,Holt Public Schools,01710,Holt 9th Grade Campus,154,0,328,482
33070,Holt Public Schools,01711,Holt Senior High School,343,0,1034,1377
33070,Holt Public Schools,02557,Midway Elementary School,90,0,245,335
33070,Holt Public Schools,04118,Sycamore Elementary School,197,0,175,372
33070,Holt Public Schools,05669,Wilcox Elementary School,95,0,232,327
33070,Holt Public Schools,06663,Hope Middle School,216,0,253,469
33070,Holt Public Schools,07621,Holt Central High School,84,0,94,178
33070,Holt Public Schools,07796,Horizon Elementary School,51,0,291,342
33070,Holt Public Schools,07797,Washington Woods Middle School,130,0,320,450
33070,Holt Public Schools,09301,Holt Junior High School,331,0,606,937
33100,Leslie Public Schools,01846,Leslie Middle School,128,43,265,436
33100,Leslie Public Schools,02164,Leslie High School,104,35,328,467
33100,Leslie Public Schools,04602,Woodworth Elementary School,186,49,249,484
33130,Mason Public Schools (Ingham),00037,Alaiedon Elementary School,101,26,275,402
33130,Mason Public Schools (Ingham),02426,Mason High School,218,73,777,1068
33130,Mason Public Schools (Ingham),02716,North Aurelius Elementary School,80,36,295,411
33130,Mason Public Schools (Ingham),04061,Steele Street Elementary School,107,14,297,418
33130,Mason Public Schools (Ingham),05883,Mason Middle School,157,48,527,732
33170,Okemos Public Schools,00614,Central Elementary School,69,15,139,223
33170,Okemos Public Schools,00801,Cornell Elementary School,44,8,282,334
33170,Okemos Public Schools,02822,Okemos High School,145,34,1217,1396
33170,Okemos Public Schools,04351,Wardcliff Elementary School,51,5,174,230
33170,Okemos Public Schools,04881,Kinawa Middle School,51,8,377,436
33170,Okemos Public Schools,07347,Hiawatha Elementary School,41,1,287,329
33170,Okemos Public Schools,07828,Bennett Woods Elementary School,21,13,262,296
33170,Okemos Public Schools,08214,Chippewa Middle School,87,22,384,493
33170,Okemos Public Schools,09348,Edgewood Public Montessori,20,2,245,267
33200,Stockbridge Community Schools,01143,Emma Smith Elementary School,122,18,200,340
33200,Stockbridge Community Schools,04077,Stockbridge Middle School,118,23,224,365
33200,Stockbridge Community Schools,04078,Stockbridge High School,136,41,348,525
33200,Stockbridge Community Schools,09141,Heritage Elementary School,145,29,237,411
33200,Stockbridge Community Schools,09374,Stockbridge Alternative High School,6,2,16,24
33215,Waverly Community Schools,02526,Meryl S. Colt Elementary School,125,35,121,281
33215,Waverly Community Schools,04402,East Intermediate School,190,48,243,481
33215,Waverly Community Schools,04403,Waverly Senior High School,294,75,681,1050
33215,Waverly Community Schools,04557,Winans Elementary School,130,28,93,251
33215,Waverly Community Schools,04560,Windemere View Elementary School,94,20,83,197
33215,Waverly Community Schools,05085,Elmwood Elementary School,93,16,115,224
33215,Waverly Community Schools,05685,Waverly Middle School,190,40,261,491
33220,Webberville Community Schools,04416,Webberville Elementary School,126,40,189,355
33220,Webberville Community Schools,04417,Webberville High School,61,18,131,210
33220,Webberville Community Schools,09726,Webberville Middle School,33,13,54,100
33230,Williamston Community Schools,04546,Williamston Middle School,60,19,377,456
33230,Williamston Community Schools,04547,Williamston Explorer Elementary School,57,13,309,379
33230,Williamston Community Schools,07526,Williamston High School,80,22,572,674
33230,Williamston Community Schools,08620,Williamston Discovery Elementary School,57,17,305,379
33901,Cole Academy,08211,Cole Academy,83,13,36,132
33902,El-Hajj Malik El-Shabazz Academy,08249,El-Hajj Malik El-Shabazz Academy,286,2,11,299
33904,Mid-Michigan Leadership Academy,08323,Mid-Michigan Leadership Academy,173,4,19,196
33906,White Pine Academy,08700,White Pine Academy,37,8,114,159
33907,Capital Area Academy,08716,Capital Area Academy,141,25,32,198
33908,New City Academy,08727,New City Academy,122,2,0,124
33909,Windemere Park Charter Academy,08720,Windemere Park Charter Academy,296,55,329,680
33910,Lansing Charter Academy,00111,Lansing Charter Academy,162,24,99,285
34000,Ionia ISD,00722,Freedom Acres School,73,8,71,152
34010,Ionia Public Schools,00001,A.A. Rather School,124,22,171,317
34010,Ionia Public Schools,01140,Emerson School,128,16,20,164
34010,Ionia Public Schools,01848,Ionia High School,354,85,524,963
34010,Ionia Public Schools,01914,Jefferson School,249,29,135,413
34010,Ionia Public Schools,04236,Twin Rivers Elementary School,144,14,83,241
34010,Ionia Public Schools,05586,R.B. Boyce Elementary School,144,36,142,322
34010,Ionia Public Schools,05827,Ionia Middle School,312,55,312,679
34010,Ionia Public Schools,08967,Douglas R. Welch Community Education Center,53,5,13,71
34040,Palo Community School District,02936,Palo Community School,42,8,28,78
34080,Belding Area School District,00600,Belding High School,227,80,347,654
34080,Belding Area School District,01115,Ellis Elementary School,269,40,179,488
34080,Belding Area School District,06426,Belding Middle School,252,72,204,528
34080,Belding Area School District,07570,"Belding Comm., Adult and Alternative Ed.",55,3,17,75
34080,Belding Area School District,08458,Woodview Elementary School,261,61,174,496
34090,Lakewood Public Schools,00707,Clarksville School,35,18,88,141
34090,Lakewood Public Schools,02113,Lakewood High School,148,75,469,692
34090,Lakewood Public Schools,04102,Sunfield Elementary School,46,14,105,165
34090,Lakewood Public Schools,04451,West Elementary School,160,55,266,481
34090,Lakewood Public Schools,04581,Woodland Elementary School,59,16,82,157
34090,Lakewood Public Schools,07836,Lakewood Middle School,133,55,323,511
34110,Portland Public School District,03098,Portland High School,124,20,520,664
34110,Portland Public School District,03101,Oakwood Elementary School,119,26,381,526
34110,Portland Public School District,06310,Portland Middle School,105,27,341,473
34110,Portland Public School District,06587,Westwood Elementary School,86,36,312,434
34120,Saranac Community Schools,01104,Harker Middle School,78,32,145,255
34120,Saranac Community Schools,03406,Saranac High School,99,33,219,351
34120,Saranac Community Schools,07567,Saranac Elementary School,193,83,274,550
34120,Saranac Community Schools,08883,Saranac Community Education,1,0,0,1
34140,Berlin Township S/D #3,05041,Coon School,8,0,27,35
34340,Easton Township S/D #6,05612,Haynor School,7,0,24,31
34360,Ionia Township S/D #2,06001,North LeValley Elem. School,8,0,2,10
35000,Iosco RESA,08870,Iosco RESA Special Education,36,11,10,57
35010,Oscoda Area Schools,00566,Cedar Lake Elementary School,171,20,67,258
35010,Oscoda Area Schools,02856,Oscoda Area High School,232,54,178,464
35010,Oscoda Area Schools,03227,Richardson Elementary School,206,34,73,313
35010,Oscoda Area Schools,08420,Richardson Middle School,190,36,93,319
35020,Hale Area Schools,01535,Hale High School,124,18,68,210
35020,Hale Area Schools,09979,Hale Elementary/Middle School,300,44,112,456
35030,Tawas Area Schools,04133,Tawas Area High School,217,52,353,622
35030,Tawas Area Schools,04134,Tawas Area Middle School,128,26,143,297
35030,Tawas Area Schools,05074,Clara B. Bolen Elementary School,249,35,188,472
35040,Whittemore-Prescott Area Schools,04516,Whittemore-Prescott Area H.S.,235,35,81,351
35040,Whittemore-Prescott Area Schools,05551,Whittemore-Prescott Elementary School,253,17,45,315
35040,Whittemore-Prescott Area Schools,07618,Whittemore-Prescott Area Middle School,215,34,49,298
35040,Whittemore-Prescott Area Schools,09966,Early Childhood Center,83,6,10,99
35901,Sunrise Education Center,08343,Sunrise Education Center,36,11,8,55
36015,Forest Park School District,00090,Orion Alternative School,28,6,9,43
36015,Forest Park School District,00847,Forest Park School,135,80,292,507
36025,West Iron County Public Schools,01852,West Iron County High School,114,29,129,272
36025,West Iron County Public Schools,04048,Stambaugh Elementary School,183,44,121,348
36025,West Iron County Public Schools,05490,West Iron County Middle School,70,18,68,156
36025,West Iron County Public Schools,09954,Bates Upper Elementary School,77,21,47,145
37010,Mt. Pleasant City School District,01202,Fancher School,83,14,206,303
37010,Mt. Pleasant City School District,01357,Ganiard School,118,17,232,367
37010,Mt. Pleasant City School District,02412,Mary McGuire School,59,10,126,195
37010,Mt. Pleasant City School District,02635,West Intermediate School,156,21,356,533
37010,Mt. Pleasant City School District,02636,Mt. Pleasant Senior High School,255,29,828,1112
37010,Mt. Pleasant City School District,03131,Pullen Elementary School,150,16,189,355
37010,Mt. Pleasant City School District,03292,Rosebush School,77,10,81,168
37010,Mt. Pleasant City School District,04315,Vowles School,164,16,247,427
37010,Mt. Pleasant City School District,07496,Oasis Alternative Ed. School,38,3,82,123
37010,Mt. Pleasant City School District,07801,Mission Creek Community Education,11,0,30,41
37010,Mt. Pleasant City School District,09750,Isabella Day Treatment,5,0,13,18
37040,Beal City Public Schools,00235,Beal City High School,77,20,255,352
37040,Beal City Public Schools,05862,Beal City Elementary School,82,23,210,315
37040,Beal City Public Schools,08590,Beal City Alternative/Adult Education Program,16,1,16,33
37060,Shepherd Public School District,03459,Shepherd  Elementary School,247,42,351,640
37060,Shepherd Public School District,03460,Shepherd  High School,125,34,341,500
37060,Shepherd Public School District,06241,Winn Elementary School,42,17,91,150
37060,Shepherd Public School District,06944,Shepherd Middle School,113,27,227,367
37060,Shepherd Public School District,07631,Odyssey Middle/High School,55,3,18,76
37901,Renaissance Public School Academy,08314,Renaissance Public School Academy,190,22,113,325
37902,Morey Charter School,08507,Morey Charter School,122,30,103,255
38000,Jackson ISD,00000,RESA/ISD students attending LEA school--38000,27,6,15,48
38000,Jackson ISD,05984,Lyle A. Torrant Center,80,15,80,175
38000,Jackson ISD,06435,Youth Home- Jackson ISD,7,0,14,21
38010,Western School District,00236,Bean Elementary School,91,25,280,396
38010,Western School District,02965,Parma Elementary School,166,45,199,410
38010,Western School District,04352,Warner Elementary School,103,22,258,383
38010,Western School District,04476,Western High School,166,59,624,849
38010,Western School District,04598,Western Middle School,204,58,413,675
38010,Western School District,07261,Woodville Community Center,95,25,51,171
38020,Vandercook Lake Public Schools,01254,Townsend Elementary School,299,50,245,594
38020,Vandercook Lake Public Schools,04284,Vandercook Lake High School,276,77,342,695
38040,Columbia School District,00412,Brooklyn Elementary School,113,26,180,319
38040,Columbia School District,00577,Columbia Middle School,95,21,255,371
38040,Columbia School District,00578,Norman Miller Elementary School,113,30,228,371
38040,Columbia School District,05598,Columbia Alternative Education,53,7,30,90
38040,Columbia School District,05884,Columbia Central High School,142,49,352,543
38050,Grass Lake Community Schools,01382,George Long Elementary School,114,37,430,581
38050,Grass Lake Community Schools,01478,Grass Lake High School,47,19,311,377
38050,Grass Lake Community Schools,09296,Grass Lake Middle School,57,25,210,292
38080,Concord Community Schools,00767,Concord Elementary School,167,33,192,392
38080,Concord Community Schools,00768,Concord High School,106,22,172,300
38080,Concord Community Schools,05973,Concord Middle School,71,17,108,196
38090,East Jackson Community Schools,00302,Bertha Robinson School,148,22,131,301
38090,East Jackson Community Schools,00989,Memorial School,190,16,75,281
38090,East Jackson Community Schools,01016,East Jackson Middle School,159,25,124,308
38090,East Jackson Community Schools,01017,East Jackson High School,179,35,215,429
38100,Hanover-Horton Schools,01561,Hanover-Horton High School,93,25,340,458
38100,Hanover-Horton Schools,06708,Hanover-Horton Middle School,69,26,227,322
38100,Hanover-Horton Schools,07630,Hanover-Horton Elementary School,168,28,361,557
38120,Michigan Center School District,00122,Arnold Elementary School,146,20,155,321
38120,Michigan Center School District,02544,Michigan Center Jr/Sr High School,268,39,351,658
38120,Michigan Center School District,03138,Keicher Elementary School,189,29,214,432
38130,Napoleon Community Schools,01065,Ezra Eby Elementary School,261,43,379,683
38130,Napoleon Community Schools,02660,Napoleon High School,121,32,301,454
38130,Napoleon Community Schools,02661,Napoleon Middle School,118,22,244,384
38130,Napoleon Community Schools,07973,Ackerson Lake Community Education,32,4,28,64
38140,Northwest Community Schools,02774,R.W. Kidder Middle School,227,50,402,679
38140,Northwest Community Schools,02966,Parnall Elementary School,247,40,349,636
38140,Northwest Community Schools,05625,Northwest High School,240,54,663,957
38140,Northwest Community Schools,06116,Northwest Elementary School,271,38,345,654
38140,Northwest Community Schools,08571,Northwest Alternative High School,39,10,26,75
38150,Springport Public Schools,03573,Springport Elementary School,204,65,191,460
38150,Springport Public Schools,03574,Springport High School,129,41,167,337
38150,Springport Public Schools,07059,Springport Middle School,96,40,100,236
38170,Jackson Public Schools,00278,Bennett School,296,36,87,419
38170,Jackson Public Schools,00550,Cascades School,186,15,50,251
38170,Jackson Public Schools,00914,Dibble Elementary School,98,31,255,384
38170,Jackson Public Schools,01334,Frost Elementary School,460,47,176,683
38170,Jackson Public Schools,01793,Hunt Elementary School,340,46,97,483
38170,Jackson Public Schools,01870,Jackson High School,759,95,734,1588
38170,Jackson Public Schools,02471,McCulloch School,197,2,14,213
38170,Jackson Public Schools,02957,Middle School at Parkside,496,61,269,826
38170,Jackson Public Schools,03449,Sharp Park Academy,97,17,85,199
38170,Jackson Public Schools,04187,TA Wilson School,261,13,57,331
38170,Jackson Public Schools,05802,Northeast Elementary School,505,54,95,654
38170,Jackson Public Schools,06417,Amy Firth Middle School,86,0,15,101
38170,Jackson Public Schools,09322,Lincoln School,14,0,3,17
38901,Da Vinci Institute,08244,Da Vinci Institute (9-12),112,17,53,182
38901,Da Vinci Institute,08659,Da Vinci Institute (K-8),87,12,51,150
38902,Paragon Charter Academy,08644,Paragon Charter Academy,260,71,313,644
38903,Jackson Arts and Technology PSA,09313,Jackson Arts and Technology PSA,151,8,4,163
39000,Kalamazoo RESA,00000,RESA/ISD students attending LEA school--39000,4,0,14,18
39000,Kalamazoo RESA,01448,Croyden Avenue School,80,15,112,207
39000,Kalamazoo RESA,07288,Young Adult Program,86,4,41,131
39000,Kalamazoo RESA,07289,Valley Center School,45,2,9,56
39000,Kalamazoo RESA,07290,Youth Center School,102,0,7,109
39000,Kalamazoo RESA,09368,Oakwood School,28,0,64,92
39000,Kalamazoo RESA,09777,Lakeside Academy,38,0,2,40
39010,Kalamazoo Public School District,00113,Arcadia Elementary School,198,23,67,288
39010,Kalamazoo Public School District,00602,Transition Services,84,0,10,94
39010,Kalamazoo Public School District,00674,Prairie Ridge Elementary School,275,38,180,493
39010,Kalamazoo Public School District,01082,Edison Environmental Science Academy,329,15,16,360
39010,Kalamazoo Public School District,01501,Greenwood Elementary School,91,12,38,141
39010,Kalamazoo Public School District,01687,Hillside Middle School,311,53,181,545
39010,Kalamazoo Public School District,01837,Indian Prairie Elementary School,72,8,170,250
39010,Kalamazoo Public School District,02209,Lincoln International Studies School,365,7,19,391
39010,Kalamazoo Public School District,02275,Loy Norrix High School,776,63,438,1277
39010,Kalamazoo Public School District,02574,Milwood Elementary School,413,29,118,560
39010,Kalamazoo Public School District,02575,Milwood Middle School,527,39,149,715
39010,Kalamazoo Public School District,02753,Northeastern Elementary School,279,20,36,335
39010,Kalamazoo Public School District,02762,Northglade Montessori School,164,11,60,235
39010,Kalamazoo Public School District,02819,Woods Lake Elementary:A Magnet Center For The Arts,400,32,58,490
39010,Kalamazoo Public School District,02962,Parkwood-Upjohn Elementary School,257,34,212,503
39010,Kalamazoo Public School District,03518,Maple Street Magnet School for the Arts,427,50,224,701
39010,Kalamazoo Public School District,03569,Spring Valley Center for Exploration,283,18,66,367
39010,Kalamazoo Public School District,04358,Washington Writers' Academy,322,5,9,336
39010,Kalamazoo Public School District,04491,King-Westwood Elementary School,197,36,277,510
39010,Kalamazoo Public School District,04558,Winchell Elementary School,119,31,300,450
39010,Kalamazoo Public School District,04600,Woodward School for Technology and Research,316,21,44,381
39010,Kalamazoo Public School District,04737,Phoenix Alternative High School,111,6,28,145
39010,Kalamazoo Public School District,06117,Kalamazoo Central High School,827,130,742,1699
39010,Kalamazoo Public School District,07303,Kalamazoo Area Math and Science Center,4,0,180,184
39010,Kalamazoo Public School District,07684,Kalamazoo Adult High School,31,0,18,49
39010,Kalamazoo Public School District,09890,El Sol Elementary,159,21,41,221
39010,Kalamazoo Public School District,09942,Linden Grove Middle School,444,45,219,708
39020,Climax-Scotts Community Schools,00723,Climax-Scotts High School,77,28,220,325
39020,Climax-Scotts Community Schools,03425,Climax-Scotts Elementary School,65,26,133,224
39020,Climax-Scotts Community Schools,09930,Climax-Scotts Adult/Alternative Ed,21,0,36,57
39030,Comstock Public Schools,00765,Comstock High School,301,44,316,661
39030,Comstock Public Schools,01042,East Elementary School,188,26,94,308
39030,Comstock Public Schools,01489,Green Meadow Elementary School,250,26,74,350
39030,Comstock Public Schools,02725,North Elementary School,195,31,138,364
39030,Comstock Public Schools,05038,Comstock Compass High School,156,4,61,221
39030,Comstock Public Schools,06391,Northeast Middle School,295,37,159,491
39050,Galesburg-Augusta Community Schools,01351,Galesburg-Augusta Primary School,187,29,190,406
39050,Galesburg-Augusta Community Schools,01352,Galesburg-Augusta High School,130,20,206,356
39050,Galesburg-Augusta Community Schools,04856,Galesburg-Augusta Intermediate School,72,11,87,170
39050,Galesburg-Augusta Community Schools,06953,Galesburg-Augusta Middle School,110,28,150,288
39065,Gull Lake Community Schools,01519,Gull Lake Middle School,104,16,598,718
39065,Gull Lake Community Schools,01520,Gull Lake High School,95,19,818,932
39065,Gull Lake Community Schools,02003,Kellogg Elementary School,44,18,246,308
39065,Gull Lake Community Schools,03191,Richland Elementary School,101,12,336,449
39065,Gull Lake Community Schools,05144,Thomas M. Ryan  Intermediate School,93,13,332,438
39130,Parchment School District,00201,Barclay Hills Education Center,115,5,47,167
39130,Parchment School District,02938,Parchment High School,139,40,301,480
39130,Parchment School District,02939,Parchment Middle School,157,27,210,394
39130,Parchment School District,02940,Parchment Northwood Elem. School,115,8,99,222
39130,Parchment School District,02941,Parchment North Elem. School,114,20,107,241
39130,Parchment School District,05885,Parchment Central Elem. School,114,16,133,263
39140,Portage Public Schools,00081,Amberly Elementary School,141,13,413,567
39140,Portage Public Schools,00100,Angling Road Elementary School,84,20,309,413
39140,Portage Public Schools,00583,Central Elementary School,115,30,321,466
39140,Portage Public Schools,01610,Haverhill Elementary School,111,26,282,419
39140,Portage Public Schools,02076,Lake Center Elementary School,69,31,491,591
39140,Portage Public Schools,02561,Portage Community High School,171,13,95,279
39140,Portage Public Schools,03094,Portage Central Middle School,128,51,522,701
39140,Portage Public Schools,03095,Portage Central High School,158,41,1155,1354
39140,Portage Public Schools,03096,Portage North Middle School,182,56,405,643
39140,Portage Public Schools,03097,Portage Northern High School,185,66,1043,1294
39140,Portage Public Schools,04405,Waylee Elementary School,0,0,1,1
39140,Portage Public Schools,05561,Woodland Elementary School,101,21,253,375
39140,Portage Public Schools,06396,Portage West Middle School,59,21,603,683
39140,Portage Public Schools,07926,Moorsbridge Elementary School,60,17,395,472
39140,Portage Public Schools,09848,12th Street Elementary,119,11,391,521
39160,Schoolcraft Community Schools,03416,Schoolcraft Early Elem. School,23,11,214,248
39160,Schoolcraft Community Schools,03417,Schoolcraft High School,25,19,351,395
39160,Schoolcraft Community Schools,05799,Schoolcraft Middle School,19,10,240,269
39160,Schoolcraft Community Schools,08697,Schoolcraft Upper Elem. School,22,11,224,257
39170,Vicksburg Community Schools,01031,Vicksburg Middle School,149,45,392,586
39170,Vicksburg Community Schools,01836,Indian Lake Elementary School,99,21,230,350
39170,Vicksburg Community Schools,04104,Sunset Lake Elementary School,142,32,321,495
39170,Vicksburg Community Schools,04185,Tobey Elementary School,68,26,256,350
39170,Vicksburg Community Schools,04299,Vicksburg High School,174,59,625,858
39170,Vicksburg Community Schools,07890,Adult and Community Ed. Building,3,0,5,8
39903,Oakland Academy,08616,Oakland Academy,45,16,166,227
39905,Paramount Charter Academy,08642,Paramount Charter Academy,220,80,393,693
39906,Youth Advancement Academy,09913,Youth Advancement Academy,31,3,1,35
40020,Forest Area Community Schools,03504,South Boardman Elementary School,120,24,42,186
40020,Forest Area Community Schools,05097,Fife Lake Elementary School,85,23,45,153
40020,Forest Area Community Schools,06632,Forest Area High School,137,28,96,261
40020,Forest Area Community Schools,07881,Forest Area Middle School,87,24,46,157
40040,Kalkaska Public Schools,01991,Cherry Street Intermediate School,106,19,79,204
40040,Kalkaska Public Schools,01992,Kalkaska High School,194,50,227,471
40040,Kalkaska Public Schools,03150,Rapid City Elementary School,63,8,38,109
40040,Kalkaska Public Schools,05803,Kalkaska Middle School,146,42,141,329
40040,Kalkaska Public Schools,06664,Birch Street Elementary School,203,32,131,366
40040,Kalkaska Public Schools,08597,Northside Educational Center,60,2,24,86
40060,Excelsior Township S/D #1,00827,Crawford School,31,7,15,53
41010,Grand Rapids Public Schools,00050,Alexander School,140,2,6,148
41010,Grand Rapids Public Schools,00417,Brookside School,255,6,28,289
41010,Grand Rapids Public Schools,00436,Buchanan School,433,15,22,470
41010,Grand Rapids Public Schools,00467,Burton Middle School,426,10,7,443
41010,Grand Rapids Public Schools,00508,Campau Park School,253,5,13,271
41010,Grand Rapids Public Schools,00601,Central High School,539,47,58,644
41010,Grand Rapids Public Schools,00671,Waalkes Juvenile Center School,28,0,35,63
41010,Grand Rapids Public Schools,00830,Creston High School,723,60,132,915
41010,Grand Rapids Public Schools,00917,Dickinson School,322,8,11,341
41010,Grand Rapids Public Schools,01026,East Leonard School,260,5,4,269
41010,Grand Rapids Public Schools,01539,Cesar E. Chavez Elementary,416,4,15,435
41010,Grand Rapids Public Schools,01630,Martin Luther King Leadership Academy,482,8,19,509
41010,Grand Rapids Public Schools,02011,Ken-O-Sha Park School,157,18,34,209
41010,Grand Rapids Public Schools,02021,Kent Hills School,352,19,32,403
41010,Grand Rapids Public Schools,02223,Lincoln School,114,10,51,175
41010,Grand Rapids Public Schools,02806,Kent Educ Center--Oakleigh,42,2,6,50
41010,Grand Rapids Public Schools,02931,Palmer School,268,20,24,312
41010,Grand Rapids Public Schools,03099,Shawnee Park Oral-Deaf Center,21,5,11,37
41010,Grand Rapids Public Schools,03197,Ottawa Hills High School,721,45,106,872
41010,Grand Rapids Public Schools,03218,Riverside Middle School,437,17,29,483
41010,Grand Rapids Public Schools,03450,Shawmut Hills School,155,14,62,231
41010,Grand Rapids Public Schools,03474,Sibley School,356,15,17,388
41010,Grand Rapids Public Schools,04079,Stocking School,383,17,9,409
41010,Grand Rapids Public Schools,04251,Union High School,871,44,145,1060
41010,Grand Rapids Public Schools,04489,Westwood Middle School,335,17,20,372
41010,Grand Rapids Public Schools,05156,City Middle/High School,196,62,429,687
41010,Grand Rapids Public Schools,05829,Burton Elementary School,363,16,9,388
41010,Grand Rapids Public Schools,05831,Harrison Park Elementary School,480,18,37,535
41010,Grand Rapids Public Schools,05839,Park School,33,1,3,37
41010,Grand Rapids Public Schools,05886,Sherwood Global Studies Academy,340,24,70,434
41010,Grand Rapids Public Schools,06434,Kent Education Center--Mayfield,42,3,12,57
41010,Grand Rapids Public Schools,06505,SouthEast Academic Center,98,5,2,105
41010,Grand Rapids Public Schools,06741,Lincoln Developmental Center,47,5,51,103
41010,Grand Rapids Public Schools,07386,North Park Montessori Academy,54,23,81,158
41010,Grand Rapids Public Schools,07784,Bethany Based School,5,0,18,23
41010,Grand Rapids Public Schools,07992,Campus Early Childhood Center,0,0,1,1
41010,Grand Rapids Public Schools,08227,CBOT School,15,0,32,47
41010,Grand Rapids Public Schools,08229,Kent Vocational Options,149,1,32,182
41010,Grand Rapids Public Schools,08231,Day Treatment,11,0,3,14
41010,Grand Rapids Public Schools,08239,Creston Community School,17,1,14,32
41010,Grand Rapids Public Schools,08361,Grand Rapids Montessori Public School,177,32,116,325
41010,Grand Rapids Public Schools,08362,Adelante High School,121,2,18,141
41010,Grand Rapids Public Schools,08366,Southeast Career Pathways,170,7,33,210
41010,Grand Rapids Public Schools,08367,Central Community School,20,2,8,30
41010,Grand Rapids Public Schools,08441,Kent Education Center--Beltline,78,4,24,106
41010,Grand Rapids Public Schools,08554,Blandford Nature Center,17,4,39,60
41010,Grand Rapids Public Schools,08555,John Ball Park Zoo School,17,4,39,60
41010,Grand Rapids Public Schools,08556,Kent Co. Correction Facility,15,0,26,41
41010,Grand Rapids Public Schools,08860,Shared Time,5,0,39,44
41010,Grand Rapids Public Schools,08900,The Haven,10,0,8,18
41010,Grand Rapids Public Schools,08923,Union Community School,42,1,9,52
41010,Grand Rapids Public Schools,08947,Wellerwood Early Childhood Center,4,0,5,9
41010,Grand Rapids Public Schools,08949,Northwest Career Pathways,155,7,29,191
41010,Grand Rapids Public Schools,09061,Coit Arts Academy,228,20,16,264
41010,Grand Rapids Public Schools,09107,Home Education Site,19,0,1,20
41010,Grand Rapids Public Schools,09280,Aberdeen Elementary,165,17,30,212
41010,Grand Rapids Public Schools,09281,CA Frost Environmental Science Academy,266,58,166,490
41010,Grand Rapids Public Schools,09282,Campus Elementary,199,14,8,221
41010,Grand Rapids Public Schools,09283,Congress Elementary,231,7,6,244
41010,Grand Rapids Public Schools,09284,Covell Elementary,255,15,50,320
41010,Grand Rapids Public Schools,09285,Harrison Middle School,297,9,4,310
41010,Grand Rapids Public Schools,09287,Mulick Elementary,346,12,26,384
41010,Grand Rapids Public Schools,09288,North Park Elementary,77,19,40,136
41010,Grand Rapids Public Schools,09289,"Shawnee Science, Math and Tech. Academy",264,17,35,316
41010,Grand Rapids Public Schools,09290,Southwest Community Campus School,674,25,34,733
41010,Grand Rapids Public Schools,09538,Alger Middle School,466,18,39,523
41010,Grand Rapids Public Schools,09539,Gerald R. Ford Middle School,286,6,12,304
41010,Grand Rapids Public Schools,09542,School of Construction,31,0,61,92
41010,Grand Rapids Public Schools,09898,Grand Rapids University Preparatory Academy,139,15,26,180
41010,Grand Rapids Public Schools,09899,Center for Economicology,15,3,14,32
41010,Grand Rapids Public Schools,09943,Pine Grove Learning Center,34,2,31,67
41020,Godwin Heights Public Schools,01434,Godwin Heights Senior High School,329,67,172,568
41020,Godwin Heights Public Schools,02730,North Godwin Elementary School,256,49,92,397
41020,Godwin Heights Public Schools,03513,South Godwin Elementary School,249,24,34,307
41020,Godwin Heights Public Schools,04004,Godwin Heights Middle School,185,28,55,268
41020,Godwin Heights Public Schools,04453,West Godwin Elementary School,319,35,73,427
41020,Godwin Heights Public Schools,08423,Godwin Heights Learning Center,145,4,105,254
41025,Northview Public School District,01028,East Oakview Elementary School,146,36,231,413
41025,Northview Public School District,02742,North Oakview Elementary School,128,32,262,422
41025,Northview Public School District,02768,Northview High School,293,111,776,1180
41025,Northview Public School District,02769,Crossroads Middle School,150,42,315,507
41025,Northview Public School District,04461,West Oakview Elementary School,104,30,116,250
41025,Northview Public School District,04927,Highlands School,189,45,286,520
41025,Northview Public School District,07694,Northview Alternative High School,89,5,67,161
41026,Wyoming Public Schools,01409,Gladiola Elementary School,271,41,126,438
41026,Wyoming Public Schools,01872,Jackson Park Middle School,351,61,137,549
41026,Wyoming Public Schools,02695,Newhall Middle School,417,77,234,728
41026,Wyoming Public Schools,02959,Parkview Elementary School,227,45,61,333
41026,Wyoming Public Schools,03253,Rogers High School,453,86,367,906
41026,Wyoming Public Schools,03537,Oriole Park Elementary School,186,46,223,455
41026,Wyoming Public Schools,04126,Taft Elementary School,261,30,17,308
41026,Wyoming Public Schools,04472,West Elementary School,153,47,140,340
41026,Wyoming Public Schools,04610,Wyoming Park High School,353,73,383,809
41026,Wyoming Public Schools,09885,Innovations Academy,210,15,69,294
41040,Byron Center Public Schools,00475,Byron Center High School,166,84,775,1025
41040,Byron Center Public Schools,00476,Brown Elementary School,104,26,354,484
41040,Byron Center Public Schools,04906,Byron Center West Middle School,102,38,366,506
41040,Byron Center Public Schools,05260,Marshall Elementary School,73,19,293,385
41040,Byron Center Public Schools,08667,Robert L. Nickels Intermediate School,104,31,343,478
41040,Byron Center Public Schools,09170,Countryside Elementary School,86,33,334,453
41050,Caledonia Community Schools,00491,Caledonia High School,142,77,1121,1340
41050,Caledonia Community Schools,00492,Caledonia Elementary School,67,31,324,422
41050,Caledonia Community Schools,00495,Kraft Meadows Middle School,52,45,356,453
41050,Caledonia Community Schools,05067,Dutton Elementary School,86,41,254,381
41050,Caledonia Community Schools,05212,Kettle Lake Elementary School,38,17,354,409
41050,Caledonia Community Schools,08708,Emmons Lake Elementary School,34,25,420,479
41050,Caledonia Community Schools,08973,Glenmor High School,6,1,13,20
41050,Caledonia Community Schools,09403,Duncan Lake Middle School,60,33,345,438
41050,Caledonia Community Schools,09504,Duncan Lake Early Childhood Center,27,6,135,168
41050,Caledonia Community Schools,09723,Duncan Lake Transitions Program,26,0,5,31
41070,Cedar Springs Public Schools,00568,Cedar Springs Middle School,168,51,282,501
41070,Cedar Springs Public Schools,00570,Cedar Springs High School,289,77,641,1007
41070,Cedar Springs Public Schools,08033,New Beginnings Alternative High School,55,6,33,94
41070,Cedar Springs Public Schools,08405,Cedar Trails Elementary School,213,55,297,565
41070,Cedar Springs Public Schools,09523,Cedar Springs Elementary,1,0,0,1
41070,Cedar Springs Public Schools,09524,Red Hawk Elementary,75,25,131,231
41070,Cedar Springs Public Schools,09743,R1TS,15,2,11,28
41070,Cedar Springs Public Schools,09955,Cedar View Elementary School,181,43,260,484
41070,Cedar Springs Public Schools,09956,Beach Elementary School,175,53,259,487
41080,Comstock Park Public Schools,00766,Comstock Park High School,193,59,494,746
41080,Comstock Park Public Schools,04085,Stoney Creek Elementary,151,24,157,332
41080,Comstock Park Public Schools,05139,Greenridge Elementary,116,0,116,232
41080,Comstock Park Public Schools,07061,North Kent High School,60,4,42,106
41080,Comstock Park Public Schools,08059,Mill Creek Middle School,175,50,276,501
41080,Comstock Park Public Schools,08598,Pine Island Elementary,245,58,222,525
41090,East Grand Rapids Public Schools,00393,Breton Downs School,28,10,402,440
41090,East Grand Rapids Public Schools,01012,East Grand Rapids Middle School,59,14,657,730
41090,East Grand Rapids Public Schools,01013,East Grand Rapids High School,84,14,819,917
41090,East Grand Rapids Public Schools,02100,Lakeside School,19,6,437,462
41090,East Grand Rapids Public Schools,04409,Wealthy School,28,1,408,437
41110,Forest Hills Public Schools,00014,Ada Elementary School,24,7,421,452
41110,Forest Hills Public Schools,00751,Collins Elementary School,42,16,402,460
41110,Forest Hills Public Schools,01264,Central Middle School,44,19,601,664
41110,Forest Hills Public Schools,01265,Central High School,65,14,1248,1327
41110,Forest Hills Public Schools,02849,Orchard View Elementary School,59,18,491,568
41110,Forest Hills Public Schools,04175,Thornapple Elementary School,19,6,405,430
41110,Forest Hills Public Schools,06294,Northern High School,113,23,829,965
41110,Forest Hills Public Schools,06666,Pine Ridge Elementary School,40,8,505,553
41110,Forest Hills Public Schools,06762,Northern Hills Middle School,49,17,452,518
41110,Forest Hills Public Schools,07638,Meadow Brook Elementary School,76,10,387,473
41110,Forest Hills Public Schools,08541,Northern Trails 5/6 School,56,7,450,513
41110,Forest Hills Public Schools,08542,Central Woodlands 5/6 School,37,18,542,597
41110,Forest Hills Public Schools,08911,Goodwillie Environmental School,1,1,98,100
41110,Forest Hills Public Schools,09069,Ada Vista Elementary School,12,0,504,516
41110,Forest Hills Public Schools,09181,Knapp Forest Elementary School,39,9,628,676
41110,Forest Hills Public Schools,09315,Eastern Middle School,35,10,343,388
41110,Forest Hills Public Schools,09316,Eastern High School,43,17,882,942
41110,Forest Hills Public Schools,09712,Forest Hills Transition Center,4,1,17,22
41120,Godfrey-Lee Public Schools,00493,Lee Middle School,266,31,36,333
41120,Godfrey-Lee Public Schools,01431,Godfrey Elementary School,282,23,56,361
41120,Godfrey-Lee Public Schools,02148,Lee High School,279,28,48,355
41120,Godfrey-Lee Public Schools,07210,Vision Quest Alternative H.S.,133,11,71,215
41120,Godfrey-Lee Public Schools,08709,Godfrey-Lee Early Childhood Ctr.,320,30,63,413
41130,Grandville Public Schools,00594,Grandville Central Elementary School,80,20,131,231
41130,Grandville Public Schools,00851,Grandville Cummings Elementary School,116,33,367,516
41130,Grandville Public Schools,01006,Grandville East Elementary School,146,48,152,346
41130,Grandville Public Schools,01462,Grandville Middle School,167,69,671,907
41130,Grandville Public Schools,01463,Grandville High School,277,112,1466,1855
41130,Grandville Public Schools,01466,Grandville South Elementary School,59,33,308,400
41130,Grandville Public Schools,04450,Grandville West Elementary School,114,29,232,375
41130,Grandville Public Schools,07062,Grandville Orion High School,42,7,54,103
41130,Grandville Public Schools,07388,Grandville Grand View Elementary School,66,30,487,583
41130,Grandville Public Schools,08880,Grandville Century Park Learning Center,56,20,497,573
41140,Kelloggsville Public Schools,01023,East Kelloggsville School,252,29,65,346
41140,Kelloggsville Public Schools,02004,Kelloggsville Middle School,298,66,111,475
41140,Kelloggsville Public Schools,02005,Kelloggsville High School,295,60,225,580
41140,Kelloggsville Public Schools,02006,Southeast Kelloggsville School,203,41,64,308
41140,Kelloggsville Public Schools,03308,Discovery Alternative H.S.,143,11,86,240
41140,Kelloggsville Public Schools,04459,West Kelloggsville School,215,23,87,325
41140,Kelloggsville Public Schools,09514,Kelloggsville Early Childhood Center,9,1,19,29
41145,Kenowa Hills Public Schools,01193,Fairview Elementary School,80,20,75,175
41145,Kenowa Hills Public Schools,02017,Kenowa Hills High School,298,83,826,1207
41145,Kenowa Hills Public Schools,02386,Marne Elementary School,36,11,134,181
41145,Kenowa Hills Public Schools,04335,Walker Station School,59,23,137,219
41145,Kenowa Hills Public Schools,04627,Zinser Elementary School,100,16,162,278
41145,Kenowa Hills Public Schools,05529,Kenowa Hills Middle School,152,46,326,524
41145,Kenowa Hills Public Schools,06003,Alpine Elementary School,231,29,101,361
41145,Kenowa Hills Public Schools,08745,Kenowa Hills Intermediate School,200,45,264,509
41150,Kent City Community Schools,02019,Kent City High School,92,34,314,440
41150,Kent City Community Schools,06298,Kent City Elementary School,204,57,364,625
41150,Kent City Community Schools,09384,Kent City Middle School,66,33,182,281
41160,Kentwood Public Schools,00369,Bowen Elementary,188,14,69,271
41160,Kentwood Public Schools,00419,Brookwood Elementary,135,36,129,300
41160,Kentwood Public Schools,01427,Glenwood Elementary,213,15,96,324
41160,Kentwood Public Schools,02022,Crestwood Middle School,341,47,235,623
41160,Kentwood Public Schools,02500,Meadowlawn Elementary,216,24,115,355
41160,Kentwood Public Schools,03556,Southwood Elementary,198,30,90,318
41160,Kentwood Public Schools,04194,Townline Elementary,218,28,55,301
41160,Kentwood Public Schools,05523,Valleywood Middle School,278,39,163,480
41160,Kentwood Public Schools,05974,East Kentwood High School,667,144,1074,1885
41160,Kentwood Public Schools,07454,Challenger Elementary,201,27,130,358
41160,Kentwood Public Schools,07562,Pinewood Middle School,280,60,409,749
41160,Kentwood Public Schools,07805,Explorer Elementary,170,26,272,468
41160,Kentwood Public Schools,07994,East Kentwood Freshman Campus,354,79,348,781
41160,Kentwood Public Schools,08172,Crossroads Alternative High School,176,16,101,293
41160,Kentwood Public Schools,08353,Endeavor Elementary,192,31,267,490
41160,Kentwood Public Schools,09669,Discovery Elementary,212,52,255,519
41160,Kentwood Public Schools,09961,Pine Rest - Kentwood Public Schools,6,0,53,59
41170,Lowell Area Schools,00076,Alto Elementary School,92,30,326,448
41170,Lowell Area Schools,02272,Lowell Senior High School,220,95,967,1282
41170,Lowell Area Schools,05001,Bushnell Elementary School,106,25,204,335
41170,Lowell Area Schools,05387,Unity Alternative School,8,2,14,24
41170,Lowell Area Schools,06357,Lowell Middle School,183,78,578,839
41170,Lowell Area Schools,08003,Cherry Creek Elementary School,156,45,304,505
41170,Lowell Area Schools,09370,Murray Lake Elementary,48,26,387,461
41210,Rockford Public Schools,00269,Belmont Elementary School,38,18,303,359
41210,Rockford Public Schools,00832,Crestwood Elementary School,33,13,414,460
41210,Rockford Public Schools,02094,Lakes Elementary School,85,23,441,549
41210,Rockford Public Schools,02958,Parkside Elementary School,59,12,237,308
41210,Rockford Public Schools,03246,Rockford High School,203,68,1655,1926
41210,Rockford Public Schools,04272,Valley View Elementary School,65,20,548,633
41210,Rockford Public Schools,05007,Cannonsburg Elementary School,25,0,176,201
41210,Rockford Public Schools,06306,North Rockford Middle School,112,40,705,857
41210,Rockford Public Schools,06412,Rockford H.S. Freshman Center,65,25,564,654
41210,Rockford Public Schools,07459,Roguewood Elementary School,64,17,280,361
41210,Rockford Public Schools,08576,River Valley Academy,17,2,44,63
41210,Rockford Public Schools,08713,Meadow Ridge Elementary School,86,21,303,410
41210,Rockford Public Schools,08802,East Rockford Middle School,87,39,813,939
41210,Rockford Public Schools,09391,Rockford Special Services,3,1,13,17
41210,Rockford Public Schools,09394,Rockford Community Services,1,0,7,8
41210,Rockford Public Schools,09655,Rockford Spanish Immersion,9,4,233,246
41240,Sparta Area Schools,03560,Sparta Senior High School,232,67,590,889
41240,Sparta Area Schools,03562,Sparta Middle School,200,57,349,606
41240,Sparta Area Schools,04787,Englishville School,40,6,29,75
41240,Sparta Area Schools,07467,Ridgeview Elementary School,281,46,344,671
41240,Sparta Area Schools,07884,Sparta Adult Education,50,0,34,84
41240,Sparta Area Schools,09883,Appleview Elementary School,244,56,319,619
41901,New Branches School,08019,New Branches School,144,20,81,245
41904,West MI Academy of Environmental Science,08052,West MI Academy of Environmental Science,290,53,129,472
41905,Excel Charter Academy,08246,Excel Charter Academy,206,111,408,725
41905,Excel Charter Academy,09911,Excel Charter Academy-Grand River Prep School,116,26,87,229
41908,Byron Center Charter School,08326,Byron Center Charter School,77,0,157,234
41909,Vista Charter Academy,08370,Vista Charter Academy,522,86,114,722
41910,Vanguard Charter Academy,08371,Vanguard Charter Academy,259,100,363,722
41911,Grattan Academy,08377,Grattan Academy - Elementary,23,0,42,65
41911,Grattan Academy,09302,Grattan Academy - Middle/High School,26,0,88,114
41914,Knapp Charter Academy,08484,Knapp Charter Academy,303,95,315,713
41915,Walker Charter Academy,08485,Walker Charter Academy,179,77,436,692
41916,Cross Creek Charter Academy,08515,Cross Creek Charter Academy,118,95,518,731
41917,William C. Abney Academy,08600,William C. Abney Academy,435,20,18,473
41918,Creative Technologies Academy,08633,Creative Technologies Academy,57,0,253,310
41919,Ridge Park Charter Academy,08652,Ridge Park Charter Academy,397,72,157,626
41920,Chandler Woods Charter Academy,08719,Chandler Woods Charter Academy,117,77,508,702
41921,Grand Rapids Child Discovery Center,08793,Grand Rapids Child Discovery Center,112,20,65,197
41922,Lighthouse Academy,09924,Lighthouse Academy,152,6,8,166
42030,Grant Township S/D #2,05135,Grant Township School,0,0,4,4
43040,Baldwin Community Schools,00181,Baldwin Senior High School,126,6,27,159
43040,Baldwin Community Schools,05565,Baldwin Junior High School,66,5,8,79
43040,Baldwin Community Schools,05826,Baldwin Elementary School,279,4,25,308
44000,Lapeer ISD,06544,Lapeer Co. Education and Technology  Center,49,3,40,92
44010,Lapeer Community Schools,01099,Elba Elementary School,57,25,104,186
44010,Lapeer Community Schools,02130,Lapeer West Senior High School,323,97,952,1372
44010,Lapeer Community Schools,02348,Maple Grove Elementary School,153,32,201,386
44010,Lapeer Community Schools,02451,Mayfield Elementary School,147,50,243,440
44010,Lapeer Community Schools,04233,Turrill Elementary School,191,41,132,364
44010,Lapeer Community Schools,05643,Elva Lynch Elementary School,148,43,224,415
44010,Lapeer Community Schools,05887,Zemmer Junior High School,177,57,273,507
44010,Lapeer Community Schools,06596,Lapeer East Senior High School,326,109,893,1328
44010,Lapeer Community Schools,06597,C.K. Schickler Elementary School,281,54,121,456
44010,Lapeer Community Schools,06667,Emma Murphy Elementary School,134,36,337,507
44010,Lapeer Community Schools,06668,Seaton Elementary School,59,18,107,184
44010,Lapeer Community Schools,07468,Lapeer Community High School,64,14,61,139
44020,Almont Community Schools,00073,Almont High School,134,33,441,608
44020,Almont Community Schools,00074,Almont Elementary School,85,20,239,344
44020,Almont Community Schools,08657,Orchard Primary School,97,19,278,394
44020,Almont Community Schools,09521,Almont Middle School,94,20,281,395
44050,Dryden Community Schools,00959,Dryden High School,60,17,264,341
44050,Dryden Community Schools,00960,Dryden  Elementary School,98,24,237,359
44060,Imlay City Community Schools,01811,Imlay City High School,224,60,352,636
44060,Imlay City Community Schools,01812,Weston Elementary School,266,57,207,530
44060,Imlay City Community Schools,06413,Borland Elementary School,229,72,228,529
44060,Imlay City Community Schools,07728,Imlay City Middle School,197,58,259,514
44060,Imlay City Community Schools,07729,Venture High School,38,12,31,81
44090,North Branch Area Schools,02718,North Branch High School,237,65,516,818
44090,North Branch Area Schools,05603,North Branch Elementary School,368,98,427,893
44090,North Branch Area Schools,06185,Ruth Fox Elementary School,140,45,179,364
44090,North Branch Area Schools,07972,North Branch Middle School,148,35,202,385
44090,North Branch Area Schools,09430,Quest High School,25,8,25,58
44901,Chatfield School,08451,Chatfield School,67,0,382,449
45010,Glen Lake Community Schools,01417,Maple City-Glen Lake Jr/Sr High School,74,40,303,417
45010,Glen Lake Community Schools,05119,Glen Lake Elementary School,71,35,283,389
45020,Leland Public School District,02155,Leland Public School,155,25,285,465
45040,Northport Public School District,02764,Northport Public School,66,12,74,152
45050,Suttons Bay Public Schools,04108,Suttons Bay Senior High School,88,18,212,318
45050,Suttons Bay Public Schools,04109,Suttons Bay Elementary School,104,16,123,243
45050,Suttons Bay Public Schools,08354,Suttons Bay Middle School,65,19,130,214
46000,Lenawee ISD,00565,Milton C. Porter Ed. Center,63,8,88,159
46000,Lenawee ISD,08863,Holy Cross Children's Services (Boysville),111,0,9,120
46000,Lenawee ISD,09527,Maurice Spear Campus,15,0,20,35
46010,Adrian City School District,00027,Adrian High School,434,96,513,1043
46010,Adrian City School District,00028,Adrian Middle School 5/6 Building,266,30,183,479
46010,Adrian City School District,00046,Alexander Elementary School,175,29,231,435
46010,Adrian City School District,02197,Lincoln Elementary School,135,29,77,241
46010,Adrian City School District,06301,Adrian Middle School 7/8 Building,259,41,185,485
46010,Adrian City School District,07431,Adrian Adult and Alternative Education,54,0,61,115
46010,Adrian City School District,09674,Michener Elementary School,254,24,59,337
46010,Adrian City School District,09675,Prairie Elementary School,185,25,86,296
46020,Addison Community Schools,00023,Addison Jr/Sr High School,165,30,313,508
46020,Addison Community Schools,09983,Wayne Gray Early Learning Center,77,11,103,191
46020,Addison Community Schools,09984,Panther Elementary,117,18,144,279
46040,Blissfield Community Schools,00353,Blissfield High School,82,34,280,396
46040,Blissfield Community Schools,00587,Blissfield Elementary,183,58,342,583
46040,Blissfield Community Schools,00607,Blissfield Middle School,73,28,175,276
46050,Britton-Macon Area School District,00407,Britton-Macon Area School,123,38,385,546
46060,Clinton Community Schools,00724,Clinton Elementary School,99,21,330,450
46060,Clinton Community Schools,00725,Clinton Middle School,66,14,201,281
46060,Clinton Community Schools,06184,Clinton High School,78,8,311,397
46070,Deerfield Public Schools,05876,Deerfield Public Schools,76,15,202,293
46080,Hudson Area Schools,01782,Hudson Area High School,130,12,171,313
46080,Hudson Area Schools,02202,Lincoln Elementary School,213,26,161,400
46080,Hudson Area Schools,02337,Hudson Middle School,109,9,112,230
46090,Madison School District (Lenawee),02315,Madison Elementary School,454,52,253,759
46090,Madison School District (Lenawee),02316,Madison High School,155,27,189,371
46090,Madison School District (Lenawee),07262,Madison Middle School,173,26,142,341
46100,Morenci Area Schools,02606,Morenci Area Middle School,98,30,102,230
46100,Morenci Area Schools,02607,Morenci Elementary School,152,36,141,329
46100,Morenci Area Schools,06078,Morenci Area High School,85,20,124,229
46100,Morenci Area Schools,09478,Morenci Area Schools Alternative Education,4,0,8,12
46110,Onsted Community Schools,02832,Onsted Community High School,78,17,497,592
46110,Onsted Community Schools,06358,Onsted Middle School,77,13,301,391
46110,Onsted Community Schools,08660,Onsted Elementary,168,20,496,684
46130,Sand Creek Community Schools,03393,Sand Creek High School,128,38,282,448
46130,Sand Creek Community Schools,05659,Ruth McGregor Elementary School,182,52,243,477
46140,Tecumseh Public Schools,01651,Herrick Park Elementary School,38,6,196,240
46140,Tecumseh Public Schools,02977,Patterson Elementary School,43,23,179,245
46140,Tecumseh Public Schools,04107,Sutton Elementary School,68,14,238,320
46140,Tecumseh Public Schools,04142,Tecumseh Acres Elementary School,86,13,204,303
46140,Tecumseh Public Schools,04143,Tecumseh High School,100,36,773,909
46140,Tecumseh Public Schools,04144,Tecumseh Middle School,179,31,783,993
46140,Tecumseh Public Schools,08548,Tecumseh Options Institute,12,2,22,36
47000,Livingston ESA,03613,Pathway School,54,10,125,189
47010,Brighton Area Schools,00402,Brighton High School,165,79,1883,2127
47010,Brighton Area Schools,00403,Scranton Middle School,85,37,915,1037
47010,Brighton Area Schools,01529,Hawkins Elementary School,56,16,407,479
47010,Brighton Area Schools,04449,Lindbom Elementary School,54,14,406,474
47010,Brighton Area Schools,06397,Spencer Road Elementary School,40,14,362,416
47010,Brighton Area Schools,06872,Hornung Elementary School,37,11,376,424
47010,Brighton Area Schools,07564,Hilton Road Elementary School,46,9,410,465
47010,Brighton Area Schools,09920,Brighton Alternative Education,28,0,123,151
47010,Brighton Area Schools,09990,Maltby Intermediate School,93,42,850,985
47030,Fowlerville Community Schools,01285,H.T. Smith Elementary School,183,59,407,649
47030,Fowlerville Community Schools,01286,Fowlerville High School,168,79,692,939
47030,Fowlerville Community Schools,07706,Natalie Kreeger Elementary School,187,65,447,699
47030,Fowlerville Community Schools,07712,Choices Alternative Ed,21,2,50,73
47030,Fowlerville Community Schools,08712,Fowlerville Junior High School,136,65,451,652
47060,Hartland Consolidated Schools,01600,Hartland Round Elementary School,54,24,324,402
47060,Hartland Consolidated Schools,01601,Hartland High School,157,73,1560,1790
47060,Hartland Consolidated Schools,02127,Hartland Village Elementary School,63,16,392,471
47060,Hartland Consolidated Schools,05150,Alternative Education,38,10,72,120
47060,Hartland Consolidated Schools,05789,Hartland Farms Intermediate School,94,41,716,851
47060,Hartland Consolidated Schools,06874,Hartland Lakes Elementary School,47,15,466,528
47060,Hartland Consolidated Schools,08606,Hartland M.S. at Ore Creek,98,40,768,906
47060,Hartland Consolidated Schools,09048,Creekside Elementary School,44,17,420,481
47070,Howell Public Schools,01775,Three Fires Middle School,123,68,751,942
47070,Howell Public Schools,02436,Howell High School,413,146,2054,2613
47070,Howell Public Schools,02773,Northwest Elementary School,97,35,393,525
47070,Howell Public Schools,03158,Latson Road Elementary School,115,35,308,458
47070,Howell Public Schools,03538,Southeast Elementary School,101,23,386,510
47070,Howell Public Schools,03552,Southwest Elementary School,168,31,368,567
47070,Howell Public Schools,06118,Highlander Way Middle School,236,72,769,1077
47070,Howell Public Schools,07653,Challenger Elementary School,134,43,328,505
47070,Howell Public Schools,08624,Voyager Elementary School,100,41,387,528
47070,Howell Public Schools,09167,Ruahmah J. Hutchings Elementary,79,21,491,591
47080,Pinckney Community Schools,00564,Country Elementary School,43,14,382,439
47080,Pinckney Community Schools,03037,Pinckney Elementary School,74,10,234,318
47080,Pinckney Community Schools,03038,Pinckney  Community High School,202,47,1255,1504
47080,Pinckney Community Schools,06553,Navigator School,101,30,596,727
47080,Pinckney Community Schools,07720,Farley Hill Elementary School,86,17,336,439
47080,Pinckney Community Schools,08618,Lakeland Elementary School,73,10,362,445
47080,Pinckney Community Schools,08715,Pathfinder School,115,18,632,765
47901,Kensington Woods High School,08248,Kensington Woods High School,42,12,226,280
47902,Charyl Stockwell Academy,08327,Charyl Stockwell Academy,63,7,745,815
47902,Charyl Stockwell Academy,09941,Charyl Stockwell Academy - High School,5,4,54,63
48040,Tahquamenon Area Schools,02690,Newberry Elementary School,171,24,160,355
48040,Tahquamenon Area Schools,02692,Newberry High School,101,14,168,283
48040,Tahquamenon Area Schools,05049,Newberry Middle School,92,9,122,223
49010,St. Ignace Area Schools,02135,LaSalle High School,75,30,127,232
49010,St. Ignace Area Schools,07556,St. Ignace Middle School,78,22,101,201
49010,St. Ignace Area Schools,07718,St. Ignace Juvenile Detention Facility,1,0,8,9
49010,St. Ignace Area Schools,08587,St. Ignace Elementary School,98,37,80,215
49020,Bois Blanc Pines School District,05804,Bois Blanc Pines School,1,0,2,3
49040,Les Cheneaux Community Schools,02163,Cedarville High School,37,7,66,110
49040,Les Cheneaux Community Schools,07615,Cedarville Elementary School,52,11,69,132
49040,Les Cheneaux Community Schools,08446,Cedarville Middle School,25,8,36,69
49055,Engadine Consolidated Schools,01148,Engadine Elementary School,51,24,68,143
49055,Engadine Consolidated Schools,01149,Engadine High School,34,19,72,125
49070,Moran Township School District,01509,Gros Cap School,25,7,46,78
49110,Mackinac Island Public Schools,02305,Mackinac Island School,12,11,55,78
49901,Three Lakes Academy,00130,Three Lakes Academy,33,5,24,62
50000,Macomb ISD,01330,Rockwell School,44,6,22,72
50000,Macomb ISD,01344,Maple Lane School,56,7,15,78
50000,Macomb ISD,01346,Glen H. Peters School,54,0,186,240
50000,Macomb ISD,01350,Lutz School for Work Experience,65,0,183,248
50000,Macomb ISD,01363,Keith Bovenschen School,106,9,114,229
50000,Macomb ISD,01376,Neil E. Reid High School,49,2,57,108
50000,Macomb ISD,08395,Bozymowski Center,87,22,191,300
50010,Center Line Public Schools,00580,Center Line High School,411,98,447,956
50010,Center Line Public Schools,00842,Crothers Elementary School,111,42,102,255
50010,Center Line Public Schools,01594,Miller Elementary School,265,13,72,350
50010,Center Line Public Schools,02380,Mark C. Roose Elementary School,152,25,126,303
50010,Center Line Public Schools,02445,May V. Peck Elementary School,119,25,157,301
50010,Center Line Public Schools,04575,Wolfe Middle School,348,57,272,677
50020,East Detroit Public Schools,00268,Bellview  Elementary School,136,18,157,311
50020,East Detroit Public Schools,00828,Crescentwood Elementary School,201,32,117,350
50020,East Detroit Public Schools,01003,East Detroit High School,716,116,591,1423
50020,East Detroit Public Schools,01266,Forest Park Elementary School,123,16,183,322
50020,East Detroit Public Schools,02009,Kelly Middle School,275,33,258,566
50020,East Detroit Public Schools,02820,Oakwood Middle School,336,39,172,547
50020,East Detroit Public Schools,03074,Pleasantview  Elementary School,174,12,124,310
50020,East Detroit Public Schools,03272,Roosevelt Elementary School,169,21,100,290
50020,East Detroit Public Schools,04585,Woodland Elementary School,194,11,122,327
50020,East Detroit Public Schools,07671,East Detroit Adult Education,36,0,74,110
50020,East Detroit Public Schools,08184,Kellwood  School (Alternative),87,4,48,139
50030,Roseville Community Schools,00078,Alumni Memorial Elementary School,192,34,82,308
50030,Roseville Community Schools,00937,Dort Elementary School,173,37,67,277
50030,Roseville Community Schools,01049,John R. Kment Elementary School,195,42,118,355
50030,Roseville Community Schools,01050,Eastland Middle School,186,46,126,358
50030,Roseville Community Schools,01070,Guest Community Ed. Center,76,8,29,113
50030,Roseville Community Schools,01279,Fountain Elementary School,125,43,165,333
50030,Roseville Community Schools,01800,Huron Park Elementary School,317,54,146,517
50030,Roseville Community Schools,01987,Kaiser Elementary School,207,36,111,354
50030,Roseville Community Schools,02278,Lucile S. Patton Elem. School,119,13,54,186
50030,Roseville Community Schools,03295,Roseville Middle School,305,68,173,546
50030,Roseville Community Schools,05596,Roseville High School,943,219,804,1966
50030,Roseville Community Schools,09976,Joseph G. Steenland Elementary School,326,55,165,546
50040,Anchor Bay School District,00088,Anchor Bay Middle School North,146,32,712,890
50040,Anchor Bay School District,00089,Anchor Bay High School,356,88,1498,1942
50040,Anchor Bay School District,00091,Ashley Elementary School,55,15,468,538
50040,Anchor Bay School District,00884,Dean A. Naldrett School,42,10,222,274
50040,Anchor Bay School District,06262,Lottie M. Schmidt Elem. School,71,17,279,367
50040,Anchor Bay School District,06600,Sugarbush Elementary School,38,20,263,321
50040,Anchor Bay School District,06766,Great Oaks Elementary School,50,10,412,472
50040,Anchor Bay School District,08474,Compass Pointe,29,0,67,96
50040,Anchor Bay School District,08623,Francois Maconce Elem. School,119,14,47,180
50040,Anchor Bay School District,08710,Anchor Bay Middle School South,143,28,374,545
50040,Anchor Bay School District,08892,MacDonald Elementary School,100,23,90,213
50040,Anchor Bay School District,09208,Lighthouse Elementary School,84,13,463,560
50050,Armada Area Schools,00119,Armada High School,83,34,524,641
50050,Armada Area Schools,00120,Orville C. Krause Early Elementary School,58,13,300,371
50050,Armada Area Schools,06493,Armada Middle School,69,31,440,540
50050,Armada Area Schools,08736,Macomb Academy of Arts & Sciences,4,0,78,82
50050,Armada Area Schools,08904,Orville C. Krause Later Elementary School,65,20,342,427
50070,Clintondale Community Schools,00731,Clintondale High School,444,51,277,772
50070,Clintondale Community Schools,04103,Charles C. McGlinnen School,208,33,121,362
50070,Clintondale Community Schools,05031,Clintondale Middle School,310,38,100,448
50070,Clintondale Community Schools,06183,Rainbow Elementary School,177,30,55,262
50070,Clintondale Community Schools,06767,Robbie Hall Parker School,326,21,30,377
50070,Clintondale Community Schools,07669,Continuing Education Center,1176,19,479,1674
50080,Chippewa Valley Schools,00557,Fox Elementary School,194,25,373,592
50080,Chippewa Valley Schools,00679,Chippewa Valley High School,426,91,1740,2257
50080,Chippewa Valley Schools,00728,Clinton Valley Elementary School,145,35,186,366
50080,Chippewa Valley Schools,00729,Wyandot Middle School,208,42,707,957
50080,Chippewa Valley Schools,02655,Iroquois Middle School,137,34,834,1005
50080,Chippewa Valley Schools,02821,Ojibwa Elementary School,129,31,559,719
50080,Chippewa Valley Schools,05326,Ottawa Elementary School,132,23,231,386
50080,Chippewa Valley Schools,05762,Algonquin Middle School,161,51,362,574
50080,Chippewa Valley Schools,06359,Huron Elementary School,106,19,324,449
50080,Chippewa Valley Schools,06588,Miami Elementary School,128,28,331,487
50080,Chippewa Valley Schools,07214,Mohawk Elementary School,58,17,538,613
50080,Chippewa Valley Schools,07370,Erie Elementary School,93,29,462,584
50080,Chippewa Valley Schools,07984,Chippewa Valley Adult and Mohegan Alt. Educ.,58,5,114,177
50080,Chippewa Valley Schools,07985,Seneca Middle School,156,57,966,1179
50080,Chippewa Valley Schools,07986,Cherokee Elementary School,140,30,451,621
50080,Chippewa Valley Schools,08000,Dakota High School,296,105,2076,2477
50080,Chippewa Valley Schools,08627,Cheyenne Elementary School,44,24,784,852
50080,Chippewa Valley Schools,09035,Shawnee Elementary School,92,19,714,825
50080,Chippewa Valley Schools,09670,Sequoyah Elementary School,75,14,733,822
50090,Fitzgerald Public Schools,01242,Fitzgerald Senior High School,648,83,362,1093
50090,Fitzgerald Public Schools,02623,Mound Park Elementary School,237,34,96,367
50090,Fitzgerald Public Schools,03412,Schofield Elementary School,327,23,67,417
50090,Fitzgerald Public Schools,04488,Westview Elementary School,276,23,129,428
50090,Fitzgerald Public Schools,05878,P.D. Chatterton Middle School,418,44,157,619
50090,Fitzgerald Public Schools,08903,Neigebaur Alternative Education Center,56,1,22,79
50100,Fraser Public Schools,00955,Salk Elementary School,148,39,366,553
50100,Fraser Public Schools,00978,Eisenhower Elementary School,198,38,255,491
50100,Fraser Public Schools,01308,Fraser High School,426,116,1131,1673
50100,Fraser Public Schools,02382,Mark Twain Elementary School,166,45,156,367
50100,Fraser Public Schools,03145,Ralph Waldo Emerson Elem. School,110,14,219,343
50100,Fraser Public Schools,04162,Thomas A. Edison Elem. School,156,48,225,429
50100,Fraser Public Schools,04904,Walt Disney Elementary School,86,23,257,366
50100,Fraser Public Schools,05957,Richards Middle School,234,63,490,787
50120,Lake Shore Public Schools (Macomb),01883,Rodgers Elementary School,149,34,283,466
50120,Lake Shore Public Schools (Macomb),02089,Lake Shore High School,293,110,803,1206
50120,Lake Shore Public Schools (Macomb),02433,Masonic Heights Elementary School,150,36,221,407
50120,Lake Shore Public Schools (Macomb),04304,Violet Elementary School,149,27,272,448
50120,Lake Shore Public Schools (Macomb),05197,Kennedy Middle School,246,70,476,792
50120,Lake Shore Public Schools (Macomb),07687,North Lake High School,39,0,112,151
50130,Lakeview Public Schools (Macomb),00116,Ardmore Elementary School,70,31,270,371
50130,Lakeview Public Schools (Macomb),00677,Jefferson Middle School,237,65,529,831
50130,Lakeview Public Schools (Macomb),01499,Greenwood Elementary School,83,27,178,288
50130,Lakeview Public Schools (Macomb),01573,Harmon Elementary School,101,25,196,322
50130,Lakeview Public Schools (Macomb),02105,Lakeview High School,305,85,855,1245
50130,Lakeview Public Schools (Macomb),03124,Princeton Elementary School,90,24,180,294
50140,L'Anse Creuse Public Schools,00145,Atwood Elementary School,123,34,580,737
50140,L'Anse Creuse Public Schools,00668,Chesterfield Elementary School,210,33,176,419
50140,L'Anse Creuse Public Schools,02060,L'Anse Creuse Middle School - North,130,48,506,684
50140,L'Anse Creuse Public Schools,02119,L'Anse Creuse Middle School - South,205,57,345,607
50140,L'Anse Creuse Public Schools,02124,L'Anse Creuse High School,411,113,1244,1768
50140,L'Anse Creuse Public Schools,02125,L'Anse Creuse Middle School - Central,218,49,439,706
50140,L'Anse Creuse Public Schools,02374,Marie C. Graham Elem. School,223,36,225,484
50140,L'Anse Creuse Public Schools,03530,South River Elementary School,145,26,391,562
50140,L'Anse Creuse Public Schools,05223,Green Elementary School,77,40,386,503
50140,L'Anse Creuse Public Schools,05970,Macomb County Juvenile Justice Center School,31,0,63,94
50140,L'Anse Creuse Public Schools,06360,Emma V. Lobbestael Elem. School,69,12,289,370
50140,L'Anse Creuse Public Schools,06487,L'Anse Creuse High School - North,460,101,1411,1972
50140,L'Anse Creuse Public Schools,06488,Tenniswood Elementary School,199,46,179,424
50140,L'Anse Creuse Public Schools,06550,Frederick V. Pankow Center,32,0,107,139
50140,L'Anse Creuse Public Schools,06768,Donald J. Yacks Elem. School,132,34,274,440
50140,L'Anse Creuse Public Schools,07833,L'Anse Creuse-Mount Clemens Center for Lifelong Learning,132,0,314,446
50140,L'Anse Creuse Public Schools,08242,Francis A. Higgins Elem. School,178,28,319,525
50140,L'Anse Creuse Public Schools,08735,L'Anse Creuse Middle School - East,239,59,494,792
50140,L'Anse Creuse Public Schools,08879,Joseph M. Carkenord Elementary School,177,34,389,600
50140,L'Anse Creuse Public Schools,09376,Anna Mae Burdi Early Childhood Center,16,0,35,51
50160,Mt. Clemens Community School District,02624,Mount Clemens High School,434,34,100,568
50160,Mt. Clemens Community School District,07252,Mount Clemens Junior High  School,179,14,36,229
50160,Mt. Clemens Community School District,09336,George Washington Academy,263,28,58,349
50160,Mt. Clemens Community School District,09337,M.L. King Jr. Academy,286,8,13,307
50160,Mt. Clemens Community School District,09338,Seminole Academy,341,41,99,481
50170,New Haven Community Schools,00986,E.F. Siefert Elementary School,127,20,141,288
50170,New Haven Community Schools,02683,New Haven High School,149,37,169,355
50170,New Haven Community Schools,05828,New Haven Middle School,13,1,14,28
50170,New Haven Community Schools,09437,New Haven Elementary School,248,55,271,574
50180,Richmond Community Schools,03193,Richmond Community High School,79,71,519,669
50180,Richmond Community Schools,04530,Will L. Lee School,71,81,413,565
50180,Richmond Community Schools,05958,Richmond Middle School,71,73,413,557
50190,Romeo Community Schools,00839,Croswell Elementary School,18,0,75,93
50190,Romeo Community Schools,01834,Indian Hills Elementary School,123,20,370,513
50190,Romeo Community Schools,03256,Romeo High School,309,104,1448,1861
50190,Romeo Community Schools,03257,Romeo Middle School,124,27,446,597
50190,Romeo Community Schools,04375,Washington Elementary School,115,30,308,453
50190,Romeo Community Schools,06119,Amanda Moore Elementary School,141,17,296,454
50190,Romeo Community Schools,06361,Powell Middle School,168,44,490,702
50190,Romeo Community Schools,06589,Hamilton Parsons Elem. School,76,8,365,449
50190,Romeo Community Schools,09034,Hevel Elementary,109,12,361,482
50200,South Lake Schools,00155,Avalon Elementary School,145,29,99,273
50200,South Lake Schools,01127,Elmwood Elementary School,145,37,255,437
50200,South Lake Schools,02444,South Lake Middle School,180,42,240,462
50200,South Lake Schools,03520,South Lake High School,317,76,466,859
50200,South Lake Schools,08339,Koepsell Education Center,70,19,123,212
50210,Utica Community Schools,00457,Burr Elementary School,184,30,232,446
50210,Utica Community Schools,00958,Dresden Elementary School,179,40,279,498
50210,Utica Community Schools,00983,Schwarzkoff Elementary School,167,47,425,639
50210,Utica Community Schools,01152,Eppler Junior High School,154,54,494,702
50210,Utica Community Schools,01174,Ewell Elementary School,98,17,424,539
50210,Utica Community Schools,01250,Flickinger Elementary School,96,19,265,380
50210,Utica Community Schools,01866,Jack Harvey Elementary School,79,8,319,406
50210,Utica Community Schools,02608,Morgan Elementary School,47,12,443,502
50210,Utica Community Schools,02656,Frank Jeannette Jr. High School,383,64,514,961
50210,Utica Community Schools,03077,Plumbrook Elementary School,121,13,211,345
50210,Utica Community Schools,03289,Rose Kidd Elementary School,193,29,166,388
50210,Utica Community Schools,03456,Shelby Junior High School,101,20,1157,1278
50210,Utica Community Schools,04067,Browning Elementary School,54,16,360,430
50210,Utica Community Schools,04069,Bemis Junior High School,173,47,750,970
50210,Utica Community Schools,04117,Switzer Elementary School,48,14,434,496
50210,Utica Community Schools,04267,Utica High School,264,39,1060,1363
50210,Utica Community Schools,04468,West Utica Elementary School,315,41,239,595
50210,Utica Community Schools,04526,Wiley Elementary School,186,20,391,597
50210,Utica Community Schools,04931,Adlai Stevenson High School,391,72,1615,2078
50210,Utica Community Schools,05570,Issac Monfort Elementary School,57,17,438,512
50210,Utica Community Schools,05587,Magahay Elementary School,156,11,180,347
50210,Utica Community Schools,05753,Bruce Collins Elementary School,51,26,279,356
50210,Utica Community Schools,05754,Davis Junior High School,198,46,582,826
50210,Utica Community Schools,05755,Walsh Elementary School,144,32,299,475
50210,Utica Community Schools,05756,Crissman Elementary School,46,13,552,611
50210,Utica Community Schools,05959,Eisenhower High School,111,27,1940,2078
50210,Utica Community Schools,06180,Roberts Elementary School,154,31,387,572
50210,Utica Community Schools,06181,Oakbrook Elementary School,114,33,354,501
50210,Utica Community Schools,06182,Dekeyser Elementary School,73,15,294,382
50210,Utica Community Schools,06255,Malow Junior High School,108,22,1078,1208
50210,Utica Community Schools,06263,Graebner Elementary School,143,26,442,611
50210,Utica Community Schools,06264,Havel Elementary School,75,25,395,495
50210,Utica Community Schools,06265,Henry Ford II High School,329,70,1636,2035
50210,Utica Community Schools,06769,Heritage Junior High School,122,41,459,622
50210,Utica Community Schools,06932,Schuchard Elementary School,183,36,327,546
50210,Utica Community Schools,06933,Floyd Ebeling Elementary School,60,17,554,631
50210,Utica Community Schools,07129,Messmore Elementary School,8,1,322,331
50210,Utica Community Schools,07701,Utica Learning Academy,22,0,124,146
50210,Utica Community Schools,08459,Beck Centennial Elem. School,74,12,596,682
50210,Utica Community Schools,08783,Utica Center For Applied Learning,27,10,61,98
50210,Utica Community Schools,09019,Richard J. Duncan Elementary,77,14,773,864
50210,Utica Community Schools,09533,Beacon Tree Elementary School,35,13,637,685
50220,Van Dyke Public Schools,01945,John F. Kennedy Elementary  School,264,26,43,333
50220,Van Dyke Public Schools,02201,Lincoln High School,544,55,311,910
50220,Van Dyke Public Schools,02205,Lincoln Middle School,505,49,113,667
50220,Van Dyke Public Schools,02379,Marjorie Carlson Elementary School,260,32,112,404
50220,Van Dyke Public Schools,02463,McKinley Elementary School,338,15,35,388
50220,Van Dyke Public Schools,04368,Washington  Elementary School,305,19,43,367
50220,Van Dyke Public Schools,08595,Thompson Community Center,119,2,62,183
50230,Warren Consolidated Schools,00645,Warren Mott High School,758,172,917,1847
50230,Warren Consolidated Schools,00814,Cousino Senior High School,465,138,1281,1884
50230,Warren Consolidated Schools,00835,Cromie Elementary School,185,44,406,635
50230,Warren Consolidated Schools,01486,Green Acres Elementary School,182,37,288,507
50230,Warren Consolidated Schools,02372,Black Elementary School,102,24,305,431
50230,Warren Consolidated Schools,02441,Wilde Elementary School,113,31,282,426
50230,Warren Consolidated Schools,02986,Lean Elementary School,257,30,250,537
50230,Warren Consolidated Schools,03476,Siersma Elementary School,236,40,249,525
50230,Warren Consolidated Schools,04106,Susick Elementary School,164,40,216,420
50230,Warren Consolidated Schools,04928,Wilkerson Elementary School,144,44,374,562
50230,Warren Consolidated Schools,05571,Angus Elementary School,238,47,152,437
50230,Warren Consolidated Schools,05589,Fillmore Elementary School,131,31,212,374
50230,Warren Consolidated Schools,05694,Carter Middle School,207,75,514,796
50230,Warren Consolidated Schools,05700,Beer Middle School,325,71,358,754
50230,Warren Consolidated Schools,05701,Grissom Middle School,347,66,296,709
50230,Warren Consolidated Schools,05960,Willow Woods Elementary School,118,32,182,332
50230,Warren Consolidated Schools,05961,Harwood Elementary School,211,27,144,382
50230,Warren Consolidated Schools,05962,Hatherly Elementary School,197,29,179,405
50230,Warren Consolidated Schools,06019,Sterling Heights Senior H.S.,603,124,683,1410
50230,Warren Consolidated Schools,06121,Carleton Middle School,192,50,374,616
50230,Warren Consolidated Schools,06123,Holden Elementary School,227,39,122,388
50230,Warren Consolidated Schools,06291,Flynn Middle School,322,66,234,622
50230,Warren Consolidated Schools,06549,Career Preparation Center,16,0,46,62
50230,Warren Consolidated Schools,06684,Jefferson Elementary School,207,47,180,434
50230,Warren Consolidated Schools,08397,Butcher Community Center,119,13,253,385
50230,Warren Consolidated Schools,09988,North Star Academy,9,0,14,23
50240,Warren Woods Public Schools,04355,Warren Woods Middle School,260,89,449,798
50240,Warren Woods Public Schools,04490,Westwood Elementary School,179,55,247,481
50240,Warren Woods Public Schools,04990,Briarwood Elementary School,119,36,164,319
50240,Warren Woods Public Schools,05658,Pinewood Elementary School,127,43,229,399
50240,Warren Woods Public Schools,06267,Warren Woods Tower High School,385,104,860,1349
50240,Warren Woods Public Schools,07575,Warren Woods Enterprise H.S.,56,20,75,151
50240,Warren Woods Public Schools,07885,Warren Woods Adult Education,13,0,30,43
50901,Macomb Academy,08051,Macomb Academy,30,0,142,172
50902,Conner Creek Academy East,08726,Conner Creek Academy East - Elementary,398,48,88,534
50902,Conner Creek Academy East,09089,Conner Creek Academy East-MI Collegiate High,165,21,150,336
50902,Conner Creek Academy East,09310,Conner Creek Academy East-MI Collegiate Middle,102,14,46,162
50903,Huron Academy,08725,Huron Academy,177,25,226,428
50904,Conner Creek Academy,08737,Conner Creek Academy,158,6,16,180
50904,Conner Creek Academy,09098,Conner Creek Academy - High,203,15,47,265
50905,Arts Academy in the Woods,08884,Arts Academy in the Woods,80,11,187,278
50906,Merritt Academy,09077,Merritt Academy,164,15,214,393
50908,Mt. Clemens Montessori Academy,09294,Mt. Clemens Montessori Academy,40,0,278,318
50909,Prevail Academy,09451,Prevail Academy,336,65,330,731
50910,Ben Ross Public School Academy,09443,Ben Ross Public School Academy,374,33,35,442
50911,Academy of Warren,09602,Academy of Warren,831,9,4,844
50912,Reach Charter Academy,09905,Reach Charter Academy,255,63,207,525
51000,Manistee ISD,08937,Manistee ISD Center Programs,21,6,11,38
51020,Bear Lake School District,00237,Bear Lake High School,62,17,71,150
51020,Bear Lake School District,06035,Bear Lake Elementary School,106,15,88,209
51045,Kaleva Norman Dickson School District,00392,Brethren High School,120,18,76,214
51045,Kaleva Norman Dickson School District,01990,Kaleva Elementary School,1,0,0,1
51045,Kaleva Norman Dickson School District,08746,Brethren Middle School,108,16,52,176
51045,Kaleva Norman Dickson School District,09989,KND Elementary,193,17,76,286
51060,Onekama Consolidated Schools,02831,Onekama  Elementary School,62,17,106,185
51060,Onekama Consolidated Schools,05855,Onekama  Middle/High School,53,21,147,221
51070,Manistee Area Schools,01912,Thomas Jefferson Elem. School,110,31,166,307
51070,Manistee Area Schools,02016,John F. Kennedy Elem. School,107,25,110,242
51070,Manistee Area Schools,02321,James Madison Elementary School,133,18,84,235
51070,Manistee Area Schools,02339,Manistee High School,141,62,318,521
51070,Manistee Area Schools,06743,Manistee Middle School,123,49,202,374
51903,Casman Alternative Academy,08477,Casman Alternative Academy,69,8,27,104
52000,Marquette-Alger RESA,08859,Marquette-Alger Administrative Unit,10,0,35,45
52015,N.I.C.E. Community Schools,06054,Westwood High School,57,27,281,365
52015,N.I.C.E. Community Schools,08499,Aspen Ridge Elementary School,169,52,324,545
52015,N.I.C.E. Community Schools,08500,Aspen Ridge Middle School,69,19,176,264
52015,N.I.C.E. Community Schools,08864,Ishpeming-Neguanee-NICE Comm. Ed. Division,37,0,18,55
52040,Gwinn Area Community Schools,01385,George D. Gilbert Elem. School,120,25,149,294
52040,Gwinn Area Community Schools,01527,Gwinn High School,178,25,226,429
52040,Gwinn Area Community Schools,01984,K.I. Sawyer Elementary School,261,25,49,335
52040,Gwinn Area Community Schools,05145,Gwinn Middle School,94,24,94,212
52090,Negaunee Public Schools,00621,Negaunee Middle School,67,21,221,309
52090,Negaunee Public Schools,02108,Lakeview School,154,54,443,651
52090,Negaunee Public Schools,02666,Negaunee High School,78,26,370,474
52100,Powell Township Schools,05362,Powell Twp. Elementary School,16,3,27,46
52110,Republic-Michigamme Schools,03182,Republic-Michigamme School,69,23,61,153
52160,Wells Township School District,04431,Wells Township School,5,2,6,13
52170,Marquette Area Public Schools,01238,Superior Hills Elementary School,99,9,260,368
52170,Marquette Area Public Schools,02389,Marquette Senior High School,144,46,883,1073
52170,Marquette Area Public Schools,03402,Sandy Knoll School,126,22,218,366
52170,Marquette Area Public Schools,06268,Bothwell Middle School,155,31,511,697
52170,Marquette Area Public Schools,07755,Marquette Alternative Education,35,2,28,65
52170,Marquette Area Public Schools,07822,Cherry Creek Elementary School,72,21,255,348
52170,Marquette Area Public Schools,09269,Graveraet Intermediate School,50,14,137,201
52170,Marquette Area Public Schools,09980,Vandenboom Child Development Center,4,1,15,20
52180,Ishpeming Public School District,00329,Birchview School,144,9,140,293
52180,Ishpeming Public School District,00481,C.L. Phelps School,94,36,164,294
52180,Ishpeming Public School District,01858,Ishpeming High School,77,35,148,260
52901,North Star Academy,08476,North Star Academy,106,16,80,202
53000,Mason-Lake ISD,00000,RESA/ISD students attending LEA school--53000,19,0,9,28
53000,Mason-Lake ISD,08874,Mason-Lake ISD Special Education,12,0,11,23
53010,Mason County Central Schools,02423,Mason County Central M.S.,186,38,148,372
53010,Mason County Central Schools,02424,Mason County Central H.S.,204,54,274,532
53010,Mason County Central Schools,03426,Scottville Elementary School,210,37,109,356
53010,Mason County Central Schools,09762,Mason County Central Upper Elementary,182,31,125,338
53020,Mason County Eastern Schools,00855,Mason County Eastern Elem. Sch.,103,29,71,203
53020,Mason County Eastern Schools,01045,Mason County Eastern Junior High/High School,133,49,98,280
53030,Free Soil Community Schools,05909,Free Soil Community Elem. School,26,3,5,34
53040,Ludington Area School District,01275,Foster School,220,31,189,440
53040,Ludington Area School District,01301,Franklin Elementary School,81,9,141,231
53040,Ludington Area School District,02109,Lakeview Elementary School,129,15,66,210
53040,Ludington Area School District,02279,Ludington High School,178,36,532,746
53040,Ludington Area School District,02792,O.J. DeJonge Middle School,147,29,261,437
53040,Ludington Area School District,09424,Journey Junior/Senior High School,81,2,36,119
54000,Mecosta-Osceola ISD,06159,Mecosta-Osceola Education Center,73,0,118,191
54000,Mecosta-Osceola ISD,09039,Ashmun School @ Eagle Village,46,0,12,58
54000,Mecosta-Osceola ISD,09040,Pineview Homes,23,0,3,26
54000,Mecosta-Osceola ISD,09041,Muskegon River Youth Home,20,0,34,54
54010,Big Rapids Public Schools,00321,Big Rapids Middle School,267,63,277,607
54010,Big Rapids Public Schools,00322,Big Rapids High School,242,50,379,671
54010,Big Rapids Public Schools,00415,Brookside Elementary School,79,21,105,205
54010,Big Rapids Public Schools,01057,Eastwood Early Childhood Center,157,17,106,280
54010,Big Rapids Public Schools,03223,Riverview Elementary School,115,15,64,194
54010,Big Rapids Public Schools,07943,New Directions High School,38,2,9,49
54025,Chippewa Hills School District,02503,Mecosta Elementary School,138,13,92,243
54025,Chippewa Hills School District,04424,Weidman Elementary School,195,22,131,348
54025,Chippewa Hills School District,04966,Chippewa Hills Intermediate School,273,53,178,504
54025,Chippewa Hills School District,05902,Barryton Elementary School,160,14,73,247
54025,Chippewa Hills School District,06178,Chippewa Hills High School,278,75,311,664
54025,Chippewa Hills School District,07764,Mosaic School,59,5,14,78
54025,Chippewa Hills School District,09055,Remus Elementary School,97,22,80,199
54040,Morley Stanwood Community Schools,02610,Morley Elementary School,163,17,84,264
54040,Morley Stanwood Community Schools,02613,Morley Stanwood High School,201,56,215,472
54040,Morley Stanwood Community Schools,04053,Stanwood Elementary School,109,20,99,228
54040,Morley Stanwood Community Schools,08494,Morley Stanwood Middle School,229,49,162,440
54040,Morley Stanwood Community Schools,09562,Morley Stanwood Alternative School,33,0,9,42
54901,Crossroads Charter Academy,08599,Crossroads Charter Academy (PK-6),180,41,142,363
54901,Crossroads Charter Academy,09187,Crossroads Charter Academy (7-12),87,30,144,261
55000,Menominee ISD,08944,Menominee ISD Special Education,16,1,7,24
55010,Carney-Nadeau Public Schools,00527,Carney-Nadeau School,129,40,116,285
55100,Menominee Area Public Schools,02514,Menominee Jr High School,93,24,155,272
55100,Menominee Area Public Schools,05695,Menominee High School,155,43,374,572
55100,Menominee Area Public Schools,09385,Central Elementary School,151,19,116,286
55100,Menominee Area Public Schools,09386,Lincoln Elementary School,113,25,112,250
55100,Menominee Area Public Schools,09387,Blesch Intermediate School,143,42,200,385
55115,North Central Area Schools,03114,North Central Area Junior/Senior High School,70,46,84,200
55115,North Central Area Schools,05987,North Central Elementary School,93,39,68,200
55115,North Central Area Schools,09599,Phoenix Alternative High School,31,1,33,65
55120,Stephenson Area Public Schools,02505,Mellen Elementary School,38,23,46,107
55120,Stephenson Area Public Schools,04065,Stephenson High School,64,45,115,224
55120,Stephenson Area Public Schools,04066,Stephenson Elementary School,99,43,85,227
55120,Stephenson Area Public Schools,09819,Stephenson Middle School,72,33,71,176
55120,Stephenson Area Public Schools,09851,The Better Alternative,4,2,4,10
55901,Nah Tah Wahsh Public School Academy,08221,Nah Tah Wahsh Public School Academy,118,17,39,174
56000,Midland County Educational Service Agency,08857,MCESA and Sugnet School Classroom Programs,55,12,61,128
56010,Midland Public Schools,00016,Adams Elementary School,51,8,423,482
56010,Midland Public Schools,00532,Carpenter School,75,11,87,173
56010,Midland Public Schools,00603,Central Middle School,190,55,179,424
56010,Midland Public Schools,00669,Chestnut Hill School,30,6,341,377
56010,Midland Public Schools,00680,Chippewassee School,75,25,77,177
56010,Midland Public Schools,00778,Cook Elementary School,48,8,267,323
56010,Midland Public Schools,01052,Eastlawn School,102,29,101,232
56010,Midland Public Schools,01902,Jefferson Middle School,76,22,707,805
56010,Midland Public Schools,02261,Longview Elementary School,136,29,50,215
56010,Midland Public Schools,02555,Midland High School,234,68,1320,1622
56010,Midland Public Schools,02573,Mills Elementary School,57,9,49,115
56010,Midland Public Schools,02750,Northeast Middle School,117,37,648,802
56010,Midland Public Schools,02947,Parkdale Elementary School,111,27,143,281
56010,Midland Public Schools,03081,Plymouth Elementary School,99,25,289,413
56010,Midland Public Schools,03475,Siebert School,48,8,388,444
56010,Midland Public Schools,05157,H.H. Dow High School,207,32,1247,1486
56010,Midland Public Schools,05813,Woodcrest Elementary School,37,7,318,362
56010,Midland Public Schools,09918,Juvenile Care Center,14,1,19,34
56010,Midland Public Schools,09919,Post Secondary Transition Program,15,1,9,25
56020,Bullock Creek School District,00443,Bullock Creek High School,164,36,429,629
56020,Bullock Creek School District,00444,Bullock Creek Elementary School,66,12,186,264
56020,Bullock Creek School District,01255,Floyd School,217,25,147,389
56020,Bullock Creek School District,03048,Pine River Elementary School,69,20,186,275
56020,Bullock Creek School District,06295,Bullock Creek Middle School,136,30,272,438
56030,Coleman Community School District,00745,Coleman Elementary School,217,38,179,434
56030,Coleman Community School District,00746,Coleman Junion/Senior High School,150,32,238,420
56050,Meridian Public Schools,02515,Meridian Elementary School,207,31,274,512
56050,Meridian Public Schools,02516,Meridian Junior High School,147,37,224,408
56050,Meridian Public Schools,05814,Meridian High School,137,35,293,465
56901,Windover High School,04561,Windover High School,72,12,32,116
56902,Midland Academy of Advanced and Creative Studies,08431,Midland Academy of Advanced and Creative Studies,37,0,211,248
56903,Academic and Career Education Academy,09696,Academic and Career Education Academy,84,9,35,128
57020,Lake City Area School District,02077,Lake City Lower Elem. School,155,22,82,259
57020,Lake City Area School District,07483,Lake City High School,188,32,165,385
57020,Lake City Area School District,07484,Lake City Middle School,131,39,78,248
57020,Lake City Area School District,08535,Lake City Upper Elem. School,160,25,78,263
57030,McBain Rural Agricultural Schools,02468,McBain High School,100,33,215,348
57030,McBain Rural Agricultural Schools,05900,McBain Elementary School,185,72,216,473
57030,McBain Rural Agricultural Schools,08428,McBain Middle School,79,37,115,231
58000,Monroe ISD,00000,RESA/ISD students attending LEA school--58000,254,34,232,520
58000,Monroe ISD,01274,Monroe County Education Center,40,10,92,142
58000,Monroe ISD,08224,Monroe County Youth Center,6,0,17,23
58000,Monroe ISD,09253,Monroe County Transition Center,15,2,43,60
58000,Monroe ISD,09396,Holy Cross Children's Services-Moreau Center,5,0,10,15
58010,Monroe Public Schools,00856,Custer Elementary School,571,78,550,1199
58010,Monroe Public Schools,01701,Hollywood Elementary School,550,62,282,894
58010,Monroe Public Schools,02342,Manor Elementary School,187,39,232,458
58010,Monroe Public Schools,02592,Monroe Middle School,424,66,508,998
58010,Monroe Public Schools,02842,Orchard Center High School,113,6,88,207
58010,Monroe Public Schools,03142,Raisinville School,153,21,286,460
58010,Monroe Public Schools,04396,Waterloo School,184,39,69,292
58010,Monroe Public Schools,06503,Monroe High School,617,133,1183,1933
58010,Monroe Public Schools,09973,Riverside Learning Center,8,2,0,10
58020,Airport Community School District,00209,Airport Alternative High School,20,4,24,48
58020,Airport Community School District,01086,Airport Senior High School,281,63,620,964
58020,Airport Community School District,01312,Fred W. Ritter Elementary School,124,26,161,311
58020,Airport Community School District,01639,Niedermeier Elementary School,55,10,68,133
58020,Airport Community School District,02262,Loren Eyler Elementary School,142,25,150,317
58020,Airport Community School District,05782,Joseph C. Sterling Elem. School,120,20,198,338
58020,Airport Community School District,06362,Wagar Junior High School,247,41,399,687
58030,Bedford Public Schools,00250,Bedford Senior High School,237,92,1334,1663
58030,Bedford Public Schools,00943,Douglas Road Elementary School,77,30,423,530
58030,Bedford Public Schools,01868,Jackman Road Elementary School,91,33,389,513
58030,Bedford Public Schools,05401,Temperance Road Elementary School,111,41,401,553
58030,Bedford Public Schools,06176,Smith Road Elementary School,102,32,290,424
58030,Bedford Public Schools,06177,Bedford Junior High School,121,74,612,807
58030,Bedford Public Schools,08887,Monroe Road Elementary School,82,51,503,636
58050,Dundee Community Schools,00967,Dundee Elementary School,174,32,443,649
58050,Dundee Community Schools,00968,Dundee Community High School,93,16,373,482
58050,Dundee Community Schools,07067,Dundee Middle School,133,36,361,530
58050,Dundee Community Schools,08848,Riverside Academy,16,1,27,44
58070,Ida Public School District,01806,Ida Elementary School,102,25,432,559
58070,Ida Public School District,01807,Ida High School,75,28,465,568
58070,Ida Public School District,01808,Ida Middle School,87,29,422,538
58080,Jefferson Schools (Monroe),01899,Sodt Elementary School,147,29,161,337
58080,Jefferson Schools (Monroe),01901,Jefferson High School,149,42,554,745
58080,Jefferson Schools (Monroe),01905,Jefferson Middle School,90,23,208,321
58080,Jefferson Schools (Monroe),06494,Jefferson Elementary 5th/6th,114,31,159,304
58080,Jefferson Schools (Monroe),07443,North Elementary School,124,28,249,401
58080,Jefferson Schools (Monroe),07834,Jefferson Alternative Education,21,1,30,52
58080,Jefferson Schools (Monroe),09772,Hurd Road Early Childhood Center,24,4,57,85
58090,Mason Consolidated Schools (Monroe),02422,Mason Central School,198,46,283,527
58090,Mason Consolidated Schools (Monroe),02428,Mason Middle School,87,26,158,271
58090,Mason Consolidated Schools (Monroe),02432,Mason Senior High School,145,33,292,470
58100,Summerfield School District,04098,Summerfield High School,39,28,212,279
58100,Summerfield School District,05280,Summerfield Middle School,11,12,95,118
58100,Summerfield School District,05907,Summerfield Elementary School,86,21,311,418
58110,Whiteford Agricultural Schools,04507,Whiteford High School,25,17,228,270
58110,Whiteford Agricultural Schools,04847,Whiteford Elementary School,38,12,225,275
58110,Whiteford Agricultural Schools,07171,Whiteford Middle School,20,15,154,189
58901,New Bedford Academy,08632,New Bedford Academy,38,2,99,139
58902,Triumph Academy,09452,Triumph Academy,250,58,328,636
59000,Montcalm Area ISD,06333,Seiter Education Service Center,42,1,31,74
59000,Montcalm Area ISD,09238,ISD/Local Center Programs,52,13,16,81
59000,Montcalm Area ISD,09902,Harold O. Steele Education Center,15,0,5,20
59020,Carson City-Crystal Area Schools,00538,Carson City Elementary School,112,34,162,308
59020,Carson City-Crystal Area Schools,00539,Carson City-Crystal High School,114,34,214,362
59020,Carson City-Crystal Area Schools,00846,Crystal Elementary School,89,15,34,138
59020,Carson City-Crystal Area Schools,07892,Carson City-Crystal Middle School,111,29,137,277
59045,Montabella Community Schools,00346,Montabella Elementary,296,22,140,458
59045,Montabella Community Schools,01091,Montabella Junior/Senior High,214,11,157,382
59070,Greenville Public Schools,00179,Baldwin Heights School,217,43,306,566
59070,Greenville Public Schools,00562,Cedar Crest Elementary School,204,32,109,345
59070,Greenville Public Schools,01497,Greenville Middle School,364,87,451,902
59070,Greenville Public Schools,01498,Greenville Senior High School,353,106,738,1197
59070,Greenville Public Schools,04343,Walnut Hills Elementary School,181,33,85,299
59070,Greenville Public Schools,05236,Lincoln Heights Elem. School,196,55,261,512
59080,Tri County Area Schools,01845,Tri County Middle School,199,46,295,540
59080,Tri County Area Schools,02298,MacNaughton School,236,57,219,512
59080,Tri County Area Schools,03397,Sand Lake Elementary School,130,34,213,377
59080,Tri County Area Schools,03440,Tri County Senior High School,213,59,471,743
59080,Tri County Area Schools,08621,Edgerton Upper Elementary School,112,20,118,250
59090,Lakeview Community Schools (Montcalm),02103,Lakeview Middle School,137,43,176,356
59090,Lakeview Community Schools (Montcalm),02104,Lakeview Elementary School,156,39,138,333
59090,Lakeview Community Schools (Montcalm),05220,Lakeview High School,183,53,291,527
59090,Lakeview Community Schools (Montcalm),08617,Bright Start Elementary School,139,35,122,296
59125,Central Montcalm Public Schools,00610,Central Montcalm High School,236,65,266,567
59125,Central Montcalm Public Schools,03461,Central Montcalm Middle School,220,45,158,423
59125,Central Montcalm Public Schools,04051,Stanton Elementary School,126,25,92,243
59125,Central Montcalm Public Schools,05406,Sheridan Elementary School,124,11,74,209
59125,Central Montcalm Public Schools,08583,Central Montcalm Public Schools Alternative,8,0,23,31
59125,Central Montcalm Public Schools,08888,Central Montcalm Upper Elem. School,237,41,163,441
59150,Vestaburg Community Schools,04296,Vestaburg Community High School,62,0,163,225
59150,Vestaburg Community Schools,05833,Vestaburg Community Elem. School,358,72,105,535
59150,Vestaburg Community Schools,08661,Vestaburg Community Middle School,58,0,131,189
59901,Threshold Academy,08478,Threshold Academy,157,7,11,175
60010,Atlanta Community Schools,03767,Atlanta Community Schools,213,26,88,327
60020,Hillman Community Schools,01684,Hillman Community Jr/Sr High School,123,24,92,239
60020,Hillman Community Schools,08495,Hillman Elementary School,161,47,67,275
61000,Muskegon Area ISD,07068,Wesley School,160,9,38,207
61010,Muskegon City School District,00359,Bluffton Elementary School,123,20,74,217
61010,Muskegon City School District,01233,Craig EI,50,1,5,56
61010,Muskegon City School District,02388,Marquette School,281,16,22,319
61010,Muskegon City School District,02491,McLaughlin Elementary School,236,6,13,255
61010,Muskegon City School District,02602,Moon Elementary School,344,10,20,374
61010,Muskegon City School District,02652,Muskegon High School,944,80,248,1272
61010,Muskegon City School District,02675,Nelson Elementary School,238,6,10,254
61010,Muskegon City School District,02705,Nims Elementary School,348,31,42,421
61010,Muskegon City School District,02817,Oakview Elementary School,418,35,45,498
61010,Muskegon City School District,04345,Steele Middle School,350,23,26,399
61010,Muskegon City School District,06247,MCEC,256,9,98,363
61010,Muskegon City School District,06290,Nelson EC,54,2,22,78
61010,Muskegon City School District,07218,Bunker Middle School,495,37,53,585
61020,Muskegon Heights School District,00987,Ellen G. Loftis School,158,1,5,164
61020,Muskegon Heights School District,01030,M.L. King Jr. Elementary School,125,3,40,168
61020,Muskegon Heights School District,01074,Edgewood Elementary School,404,6,12,422
61020,Muskegon Heights School District,01419,Glendale Early Childhood Academy,15,0,3,18
61020,Muskegon Heights School District,02651,Muskegon Heights High School,377,15,43,435
61020,Muskegon Heights School District,02653,Muskegon Heights Middle School,203,4,9,216
61020,Muskegon Heights School District,04154,Theodore Roosevelt School,214,3,13,230
61020,Muskegon Heights School District,07692,Muskegon Heights Adult/Comm. Ed.,46,1,11,58
61060,Mona Shores Public School District,00511,Campbell Elementary School,181,45,159,385
61060,Mona Shores Public School District,00692,Churchill Elementary School,64,31,268,363
61060,Mona Shores Public School District,01670,Ross Park Elementary School,147,33,224,404
61060,Mona Shores Public School District,02208,Lincoln Park Elementary School,135,33,293,461
61060,Mona Shores Public School District,02587,Mona Shores High School,285,108,932,1325
61060,Mona Shores Public School District,05815,Mona Shores Middle School,270,96,545,911
61065,Oakridge Public Schools,00534,Oakridge Upper Elementary School,228,42,134,404
61065,Oakridge Public Schools,02814,Oakridge High School,211,51,265,527
61065,Oakridge Public Schools,02815,Oakridge Middle School,146,28,124,298
61065,Oakridge Public Schools,04576,Oakridge Lower Elementary School,225,46,160,431
61065,Oakridge Public Schools,08893,Oakridge Early Childhood Center,102,17,48,167
61065,Oakridge Public Schools,09958,Oakridge Alternative & Adult Ed,44,4,18,66
61080,Fruitport Community Schools,00232,Beach Elementary School,152,32,142,326
61080,Fruitport Community Schools,01073,Edgewood Elementary School,295,64,289,648
61080,Fruitport Community Schools,01336,Fruitport High School,279,116,552,947
61080,Fruitport Community Schools,04652,Fruitport Middle School,266,95,336,697
61080,Fruitport Community Schools,05408,Shettler School,148,45,235,428
61080,Fruitport Community Schools,09471,Fruitport Alternative High School,19,2,16,37
61080,Fruitport Community Schools,09531,Fruitport Adult Education,18,0,41,59
61120,Holton Public Schools,01712,Holton Elementary School,255,43,96,394
61120,Holton Public Schools,01713,Holton High School,169,29,164,362
61120,Holton Public Schools,08910,Holton Middle School,170,33,108,311
61180,Montague Area Public Schools,02596,Montague High School,141,38,255,434
61180,Montague Area Public Schools,02673,Nellie B. Chisholm Middle School,142,42,142,326
61180,Montague Area Public Schools,03139,Oehrli Elementary School,309,64,336,709
61190,Orchard View Schools,02845,Orchard View Middle School,344,77,200,621
61190,Orchard View Schools,02847,Orchard View High School,312,93,344,749
61190,Orchard View Schools,07371,Orchard View Early Elementary,321,31,107,459
61190,Orchard View Schools,08193,Orchard View Community Education,73,0,76,149
61190,Orchard View Schools,08530,Orchard View Alternative School,29,0,28,57
61190,Orchard View Schools,09778,Cardinal Elementary,506,68,257,831
61210,Ravenna Public Schools,03154,Beechnau Elementary School,192,55,238,485
61210,Ravenna Public Schools,03155,Ravenna High School,73,33,205,311
61210,Ravenna Public Schools,05368,Ravenna Middle School,72,18,146,236
61210,Ravenna Public Schools,09766,North East Education Center,6,0,13,19
61220,Reeths-Puffer Schools,02101,Central Elementary School,154,40,313,507
61220,Reeths-Puffer Schools,02102,Reeths-Puffer Middle School,228,66,321,615
61220,Reeths-Puffer Schools,02495,McMillan Elementary School,152,21,90,263
61220,Reeths-Puffer Schools,03174,Reeths-Puffer Elementary School,167,47,238,452
61220,Reeths-Puffer Schools,03175,Reeths-Puffer High School,398,123,738,1259
61220,Reeths-Puffer Schools,05518,Twin Lake School,98,38,149,285
61220,Reeths-Puffer Schools,08609,Reeths-Puffer Intermediate Sch.,227,79,297,603
61230,North Muskegon Public Schools,02740,North Muskegon High School,42,32,207,281
61230,North Muskegon Public Schools,02741,North Muskegon Elementary School,85,39,327,451
61230,North Muskegon Public Schools,08648,North Muskegon Middle School,46,20,140,206
61240,Whitehall District Schools,04508,Whitehall Ealy Elem. School,168,32,257,457
61240,Whitehall District Schools,04509,Whitehall Middle School,151,39,289,479
61240,Whitehall District Schools,04510,Whitehall Senior High School,199,34,444,677
61240,Whitehall District Schools,07704,White Lake Area Community Ed.,110,3,121,234
61240,Whitehall District Schools,08057,Shoreline Elementary School,200,19,291,510
61240,Whitehall District Schools,09598,Muskegon County Youth Home,12,0,20,32
61902,Timberland Academy,08490,Timberland Academy,370,25,55,450
61903,WayPoint Academy,08800,WayPoint Academy,149,18,45,212
61904,Three Oaks Public School Academy,09304,Three Oaks Public School Academy,368,9,62,439
62000,Newaygo County RESA,08955,Fremont Education and Activity Center,23,3,11,37
62040,Fremont Public School District,00576,Quest High School,52,1,36,89
62040,Fremont Public School District,00863,Daisy Brook Elementary School,146,36,136,318
62040,Fremont Public School District,01324,Fremont High School,222,42,496,760
62040,Fremont Public School District,01977,Fremont Middle School,217,43,299,559
62040,Fremont Public School District,03051,Pine Street School,80,11,86,177
62040,Fremont Public School District,08461,Pathfinder Elementary School,233,52,226,511
62050,Grant Public School District,01469,Grant Elementary School,248,25,186,459
62050,Grant Public School District,01474,Grant Middle School,287,53,314,654
62050,Grant Public School District,01475,Grant High School,230,35,381,646
62050,Grant Public School District,04868,Grant Primary Center,180,21,147,348
62050,Grant Public School District,08544,Grant Learning Center,13,0,157,170
62060,Hesperia Community Schools,01654,Hesperia St. Clair Elementary School,241,29,139,409
62060,Hesperia Community Schools,01655,Hesperia High School,127,41,150,318
62060,Hesperia Community Schools,06427,Hesperia Middle School,182,40,122,344
62060,Hesperia Community Schools,07917,Hesperia Community Education,37,0,12,49
62070,Newaygo Public School District,02688,Newaygo High School,266,54,285,605
62070,Newaygo Public School District,04289,Vera Wilsie Elementary School,222,41,129,392
62070,Newaygo Public School District,06363,Newaygo Middle School,216,47,158,421
62070,Newaygo Public School District,07383,Velma Matson Upper Elementary School,206,55,118,379
62070,Newaygo Public School District,07919,Learning Center East,46,2,22,70
62090,White Cloud Public Schools,04498,Jack D. Jones Elementary School,131,11,42,184
62090,White Cloud Public Schools,04499,White Cloud High School,171,31,135,337
62090,White Cloud Public Schools,07756,White Cloud Junior High School,181,15,82,278
62090,White Cloud Public Schools,09161,White Cloud Upper Elementary School,222,24,87,333
62470,Big Jackson School District,00320,Big Jackson Public School,20,3,9,32
63010,Birmingham City School District,00292,Berkshire Middle School,49,5,706,760
63010,Birmingham City School District,00316,Beverly Elementary School,8,4,358,370
63010,Birmingham City School District,00818,Birmingham Covington School,11,0,637,648
63010,Birmingham City School District,00904,Derby Middle School,39,2,758,799
63010,Birmingham City School District,01154,Ernest W. Seaholm High School,33,6,1238,1277
63010,Birmingham City School District,01494,Greenfield Elementary School,30,4,290,324
63010,Birmingham City School District,01571,Harlan Elementary School,17,0,339,356
63010,Birmingham City School District,02995,Pembroke Elementary School,22,2,291,315
63010,Birmingham City School District,03030,Pierce Elementary School,17,0,587,604
63010,Birmingham City School District,03133,Quarton Elementary,3,4,447,454
63010,Birmingham City School District,04608,Wylie E. Groves High School,69,9,1245,1323
63010,Birmingham City School District,05670,Bingham Farms Elementary School,13,4,315,332
63010,Birmingham City School District,05686,West Maple Elementary School,22,4,544,570
63020,Ferndale Public Schools,00502,Coolidge Intermediate School,209,35,88,332
63020,Ferndale Public Schools,01222,Ferndale High School,475,87,442,1004
63020,Ferndale Public Schools,02979,John F. Kennedy School,104,31,270,405
63020,Ferndale Public Schools,04155,Roosevelt Primary School,263,28,145,436
63020,Ferndale Public Schools,07786,Ferndale Adult Education,460,0,524,984
63020,Ferndale Public Schools,09074,Ferndale Middle School,240,38,146,424
63020,Ferndale Public Schools,09561,University High School,251,51,148,450
63030,Pontiac City School District,00045,Alcott School,342,17,57,416
63030,Pontiac City School District,00187,Alternatives Unlimited Bethune,1,0,0,1
63030,Pontiac City School District,01652,Herrington School,418,19,76,513
63030,Pontiac City School District,01880,Pontiac Middle School,678,33,106,817
63030,Pontiac City School District,02756,Pontiac High School,1345,109,345,1799
63030,Pontiac City School District,02922,Owen Elementary School,303,16,72,391
63030,Pontiac City School District,04532,Rogers School,343,32,86,461
63030,Pontiac City School District,05752,Whitman Elementary School,315,20,43,378
63030,Pontiac City School District,06213,Whitmer Resource Center,357,21,51,429
63030,Pontiac City School District,08689,Kennedy Center,117,5,26,148
63030,Pontiac City School District,09960,Jefferson Whittier School,550,15,102,667
63040,School District of the City of Royal Oak,02034,Royal Oak High School,344,109,1261,1714
63040,School District of the City of Royal Oak,02781,Northwood Elementary School,62,12,394,468
63040,School District of the City of Royal Oak,02800,Oak Ridge Elementary School,74,15,347,436
63040,School District of the City of Royal Oak,02805,Oakland Elementary School,79,24,202,305
63040,School District of the City of Royal Oak,04264,Alfred E. Upton Elementary School,125,25,207,357
63040,School District of the City of Royal Oak,05932,Churchill Community Ed. Center,40,0,155,195
63040,School District of the City of Royal Oak,09740,Royal Oak Middle School,264,68,844,1176
63040,School District of the City of Royal Oak,09741,Addams Elementary,60,22,337,419
63040,School District of the City of Royal Oak,09742,Keller Elementary,66,23,247,336
63050,Berkley School District,00093,Anderson Middle School,118,24,451,593
63050,Berkley School District,00291,Berkley High School,198,38,1018,1254
63050,Berkley School District,00464,Burton Elementary School,16,0,583,599
63050,Berkley School District,01549,Rogers Elementary School,70,15,296,381
63050,Berkley School District,01875,Angell Elementary School,115,17,301,433
63050,Berkley School District,01959,Norup International School,225,15,491,731
63050,Berkley School District,02928,Tri County Educational Center,124,8,107,239
63050,Berkley School District,02974,Pattengill School,75,9,287,371
63060,Southfield Public School District,00024,Adlai Stevenson Elementary School,194,37,173,404
63060,Southfield Public School District,00056,Southfield Education Center,13,0,5,18
63060,Southfield Public School District,01311,Fred D. Leonhard Elementary School,121,37,156,314
63060,Southfield Public School District,01423,Glenn Schoenhals Elementary School,199,30,119,348
63060,Southfield Public School District,01425,Glenn W. Levey Middle School,246,53,240,539
63060,Southfield Public School District,02146,Brace-Lederle K-8 School,391,66,265,722
63060,Southfield Public School District,02295,MacArthur K-8 University Academy,167,40,339,546
63060,Southfield Public School District,02409,Mary E. Thompson Middle School,225,54,142,421
63060,Southfield Public School District,02749,Bussey Center for Early Child Education,0,0,6,6
63060,Southfield Public School District,03542,Southfield High School,528,108,596,1232
63060,Southfield Public School District,04278,Vandenberg Elementary School,193,35,108,336
63060,Southfield Public School District,05284,Morris Adler Elementary School,136,30,182,348
63060,Southfield Public School District,05419,Southfield-Lathrup High School,493,112,757,1362
63060,Southfield Public School District,05764,McIntyre Elementary School,133,34,182,349
63060,Southfield Public School District,06032,Eisenhower Elementary School,230,33,81,344
63060,Southfield Public School District,06037,Alice M. Birney Middle School,263,67,300,630
63060,Southfield Public School District,08048,Southfield Regional Academic Campus,216,27,208,451
63060,Southfield Public School District,09863,University High School Academy,30,15,125,170
63070,Avondale School District,00148,Auburn Elementary School,104,16,239,359
63070,Avondale School District,00160,Meadows Upper Elementary School,120,29,412,561
63070,Avondale School District,00161,Avondale Academy,129,16,67,212
63070,Avondale School District,05363,R. Grant Graham Elem. School,118,27,181,326
63070,Avondale School District,05976,Avondale High School,206,60,853,1119
63070,Avondale School District,07446,Deerfield Elementary School,46,27,281,354
63070,Avondale School District,07856,Avondale Middle School,130,37,406,573
63070,Avondale School District,08649,Woodland Elementary School,46,7,278,331
63080,Bloomfield Hills School District,04830,Conant Elementary School,18,3,348,369
63080,Bloomfield Hills School District,04900,West Hills Middle School,33,7,549,589
63080,Bloomfield Hills School District,04984,Bloomfield Hills Andover H.S.,47,8,945,1000
63080,Bloomfield Hills School District,05071,East Hills Middle School,45,17,496,558
63080,Bloomfield Hills School District,05076,Eastover Elementary School,54,12,418,484
63080,Bloomfield Hills School District,05538,Way Elementary School,20,4,364,388
63080,Bloomfield Hills School District,05558,Wing Lake Developmental Center,64,2,66,132
63080,Bloomfield Hills School District,05594,Bloomfield Hills Middle School,31,4,595,630
63080,Bloomfield Hills School District,05674,Bloomfield Hills Lahser H.S.,57,12,796,865
63080,Bloomfield Hills School District,05766,Lone Pine Elementary School,18,4,341,363
63080,Bloomfield Hills School District,08403,International Academy,13,2,148,163
63090,Clarenceville School District,00368,Botsford Elementary School,157,37,202,396
63090,Clarenceville School District,00699,Clarenceville Middle School,160,43,220,423
63090,Clarenceville School District,00700,Clarenceville High School,187,34,370,591
63090,Clarenceville School District,01461,Grandview Elementary School,192,26,216,434
63100,Novi Community School District,02788,Novi Woods Elementary School,15,4,439,458
63100,Novi Community School District,02843,Orchard Hills Elementary School,55,10,347,412
63100,Novi Community School District,05315,Novi High School,109,46,1865,2020
63100,Novi Community School District,06172,Novi Middle School,59,14,895,968
63100,Novi Community School District,06173,Village Oaks Elementary School,50,15,392,457
63100,Novi Community School District,07042,Novi Meadows School,70,22,908,1000
63100,Novi Community School District,07349,Parkview Elementary School,23,8,382,413
63100,Novi Community School District,07903,Novi Adult Education,9,0,43,52
63100,Novi Community School District,08804,Deerfield Elementary School,4,5,442,451
63110,Oxford Community Schools,00713,Clear Lake Elementary School,94,15,438,547
63110,Oxford Community Schools,00868,Daniel Axford Elementary School,66,18,396,480
63110,Oxford Community Schools,02160,Leonard Elementary School,80,17,181,278
63110,Oxford Community Schools,02437,Oxford High School,274,90,1039,1403
63110,Oxford Community Schools,05006,Crossroads for Youth,36,0,38,74
63110,Oxford Community Schools,05879,Oxford Area Middle School,190,65,767,1022
63110,Oxford Community Schools,07997,Oxford Elementary School,44,18,320,382
63110,Oxford Community Schools,08629,Lakeville Elementary School,132,18,267,417
63130,Hazel Park City School District,01616,Hazel Park High School,610,99,353,1062
63130,Hazel Park City School District,01753,Hoover Elementary School,210,26,87,323
63130,Hazel Park City School District,02399,Jardon Vocational School,99,3,59,161
63130,Hazel Park City School District,04159,Edison MAX Day Treatment,32,2,21,55
63130,Hazel Park City School District,04259,United Oaks Elementary School,271,28,74,373
63130,Hazel Park City School District,04422,Webster Elementary School,250,23,59,332
63130,Hazel Park City School District,07680,Hazel Park Adult Education,827,1,751,1579
63130,Hazel Park City School District,07829,Hazel Park Breakfast Club,98,3,68,169
63130,Hazel Park City School District,09362,Advantage Alternative Junior High School,33,3,5,41
63130,Hazel Park City School District,09372,Hazel Park Junior High School,443,72,187,702
63130,Hazel Park City School District,09429,Webb Elementary School,201,46,113,360
63140,Madison Public Schools (Oakland),01083,Edison Elementary School,138,17,45,200
63140,Madison Public Schools (Oakland),01537,Halfman Elementary School,189,29,47,265
63140,Madison Public Schools (Oakland),02317,Madison High School,287,39,212,538
63140,Madison Public Schools (Oakland),04528,Wilkinson Middle School,198,28,46,272
63140,Madison Public Schools (Oakland),08980,Community High School,94,7,50,151
63150,Troy School District,00174,Baker Middle School,118,29,549,696
63150,Troy School District,02161,Leonard Elementary School,15,11,429,455
63150,Troy School District,02618,Morse Elementary School,83,15,315,413
63150,Troy School District,03715,Hamilton Elementary School,22,6,381,409
63150,Troy School District,04226,Troy High School,147,48,1949,2144
63150,Troy School District,04227,Troy Union Elementary School,71,28,379,478
63150,Troy School District,05163,Hill Elementary School,37,14,288,339
63150,Troy School District,05413,Smith Middle School,62,18,613,693
63150,Troy School District,05537,Wattles Elementary School,65,11,346,422
63150,Troy School District,06124,Schroeder Elementary School,19,5,461,485
63150,Troy School District,06364,Costello Elementary School,25,12,313,350
63150,Troy School District,06365,Martell Elementary School,23,8,337,368
63150,Troy School District,06366,Larson Middle School,53,27,629,709
63150,Troy School District,06367,Boulan Park Middle School,35,6,670,711
63150,Troy School District,06393,Athens High School,144,39,1620,1803
63150,Troy School District,06939,Wass Elementary School,36,9,356,401
63150,Troy School District,06940,Bemis Elementary School,21,5,456,482
63150,Troy School District,06941,Barnard Elementary School,49,15,440,504
63150,Troy School District,07700,Troy Adult Education,6,0,15,21
63150,Troy School District,08286,Niles Community High School,31,0,113,144
63150,Troy School District,09460,Troy GROW Program,6,0,28,34
63150,Troy School District,09685,Troy Early Childhood,3,0,30,33
63160,West Bloomfield School District,01401,Ealy Elementary School,109,26,419,554
63160,West Bloomfield School District,01491,Green Elementary School,81,12,437,530
63160,West Bloomfield School District,03271,Roosevelt Elementary School,190,33,244,467
63160,West Bloomfield School District,04437,Orchard Lake Middle School,133,35,614,782
63160,West Bloomfield School District,05783,Doherty Elementary School,83,12,432,527
63160,West Bloomfield School District,06171,West Bloomfield High School,227,73,1613,1913
63160,West Bloomfield School District,06292,Abbott Middle School,129,40,605,774
63160,West Bloomfield School District,07372,Scotch Elementary School,51,24,634,709
63160,West Bloomfield School District,08259,Gretchko Elementary School,59,17,376,452
63160,West Bloomfield School District,08529,Laker Academy,17,1,60,78
63160,West Bloomfield School District,09852,Oakland Early College,25,3,116,144
63180,Brandon School District,00262,Belle Ann Elementary School,62,11,261,334
63180,Brandon School District,00385,Brandon High School,313,44,883,1240
63180,Brandon School District,05180,Oakwood Elementary School,149,14,196,359
63180,Brandon School District,05788,Brandon Middle School,140,19,369,528
63180,Brandon School District,05846,Harvey-Swanson Elementary School,134,16,255,405
63180,Brandon School District,07722,Brandon Fletcher Intermediate School,138,22,304,464
63180,Brandon School District,08560,Howard T. Burt Lifelong Learning Center,27,1,23,51
63190,Clarkston Community School District,00095,Andersonville Elementary School,104,31,275,410
63190,Clarkston Community School District,00170,Bailey Lake Elementary  School,44,21,490,555
63190,Clarkston Community School District,00704,Clarkston Elementary School,41,15,334,390
63190,Clarkston Community School District,00705,Clarkston Junior High School,174,55,1055,1284
63190,Clarkston Community School District,00706,Clarkston High School,178,41,1698,1917
63190,Clarkston Community School District,03054,Pine Knob Elementary School,124,18,405,547
63190,Clarkston Community School District,03408,Clarkston Early Childhood Center,8,0,61,69
63190,Clarkston Community School District,05624,North Sashabaw Elementary School,175,32,245,452
63190,Clarkston Community School District,05692,Sashabaw Middle School,172,55,1063,1290
63190,Clarkston Community School District,07565,Student Support Services,0,0,1,1
63190,Clarkston Community School District,08056,Springfield Plains Elem. School,54,19,506,579
63190,Clarkston Community School District,08714,Independence Elementary School,31,11,492,534
63190,Clarkston Community School District,09010,Clarkston Community Education,75,13,94,182
63200,Farmington Public School District,00255,Beechview Elementary School,66,20,331,417
63200,Farmington Public School District,00735,Cloverdale School,32,5,36,73
63200,Farmington Public School District,00994,Eagle Elementary School,61,13,288,362
63200,Farmington Public School District,01022,East Middle School,170,49,545,764
63200,Farmington Public School District,01116,William E. Miller School,4,0,29,33
63200,Farmington Public School District,01203,Visions Unlimited,44,0,50,94
63200,Farmington Public School District,01204,Farmington High School,170,58,1131,1359
63200,Farmington Public School District,01245,Flanders Elementary School,60,22,195,277
63200,Farmington Public School District,01404,Gill Elementary School,88,21,438,547
63200,Farmington Public School District,02012,Kenbrook Elementary School,64,9,371,444
63200,Farmington Public School District,02132,J.A. Lanigan Elementary School,101,31,320,452
63200,Farmington Public School District,02252,Longacre Elementary School,45,14,372,431
63200,Farmington Public School District,02729,North Farmington High School,123,26,1229,1378
63200,Farmington Public School District,02791,O.E. Dunckel Middle School,59,17,590,666
63200,Farmington Public School District,04537,William Grace Elementary School,80,25,134,239
63200,Farmington Public School District,04579,Wooddale Elementary School,28,10,249,287
63200,Farmington Public School District,04818,Power Middle School,92,36,537,665
63200,Farmington Public School District,05100,Forest Elementary School,19,3,289,311
63200,Farmington Public School District,05865,Wood Creek Elementary School,90,19,178,287
63200,Farmington Public School District,05880,Harrison High School,252,45,961,1258
63200,Farmington Public School District,06368,Warner Middle School,90,13,479,582
63200,Farmington Public School District,07251,Highmeadow Common Campus School,3,4,309,316
63200,Farmington Public School District,07444,Hillside Elementary School,59,21,469,549
63200,Farmington Public School District,08181,Farmington Community School,6,0,15,21
63200,Farmington Public School District,09733,Farmington Central High School,35,5,69,109
63210,Holly Area School District,00877,Davisburg Elementary School,87,30,277,394
63210,Holly Area School District,01698,Holly High School,320,103,834,1257
63210,Holly Area School District,01699,Holly Elementary School,155,47,191,393
63210,Holly Area School District,02976,Patterson Elementary School,221,49,199,469
63210,Holly Area School District,06398,Sherman Middle School,175,65,342,582
63210,Holly Area School District,08497,Rose Pioneer Elementary School,99,21,265,385
63210,Holly Area School District,08711,Karl Richter Campus,23,1,35,59
63210,Holly Area School District,09477,Richter Intermediate School,86,15,153,254
63220,Huron Valley Schools,00175,Baker Elementary School,95,22,153,270
63220,Huron Valley Schools,00413,Brooks Elementary School,108,31,210,349
63220,Huron Valley Schools,00964,Harbor High School,37,6,76,119
63220,Huron Valley Schools,01801,Milford High School,242,71,1285,1598
63220,Huron Valley Schools,01965,Johnson Elementary School,54,14,305,373
63220,Huron Valley Schools,02641,Muir Middle School,118,36,462,616
63220,Huron Valley Schools,04914,Highland Middle School,103,31,378,512
63220,Huron Valley Schools,05070,Oxbow Elementary School,136,22,237,395
63220,Huron Valley Schools,05759,Kurtz Elementary School,102,18,303,423
63220,Huron Valley Schools,05787,Highland Elementary School,122,24,250,396
63220,Huron Valley Schools,06489,Lakewood Elementary School,41,24,344,409
63220,Huron Valley Schools,06490,Spring Mills Elementary School,84,21,416,521
63220,Huron Valley Schools,06491,Lakeland High School,282,103,1343,1728
63220,Huron Valley Schools,06773,White Lake Middle School,112,46,439,597
63220,Huron Valley Schools,07560,Huron Valley Adult Education,8,0,38,46
63220,Huron Valley Schools,07811,Country Oaks Elementary School,103,17,570,690
63220,Huron Valley Schools,07912,Oak Valley Middle School,127,29,536,692
63220,Huron Valley Schools,08608,Heritage Elementary School,119,34,417,570
63230,Lake Orion Community Schools,00347,Blanche Sims Elementary School,99,24,279,402
63230,Lake Orion Community Schools,02085,Community Ed. Resource Center,4,0,75,79
63230,Lake Orion Community Schools,02086,Scripps Middle School,73,32,561,666
63230,Lake Orion Community Schools,02088,Lake Orion Community High School,322,142,2101,2565
63230,Lake Orion Community Schools,04414,Webber School,69,12,404,485
63230,Lake Orion Community Schools,06280,Pine Tree Elementary School,104,40,290,434
63230,Lake Orion Community Schools,06281,Stadium Drive Elementary School,54,10,425,489
63230,Lake Orion Community Schools,06405,Waldon Middle School,74,29,505,608
63230,Lake Orion Community Schools,08320,Orion Oaks Elementary School,57,17,528,602
63230,Lake Orion Community Schools,08443,Carpenter Year Round Elem. School,45,16,393,454
63230,Lake Orion Community Schools,08811,Paint Creek Elementary School,63,14,463,540
63230,Lake Orion Community Schools,09049,Oakview Middle School,98,39,418,555
63240,South Lyon Community Schools,02684,Ann L. Dolsen Elementary School,99,19,235,353
63240,South Lyon Community Schools,03380,Salem Elementary School,75,12,215,302
63240,South Lyon Community Schools,03496,Sayre Elementary School,59,22,451,532
63240,South Lyon Community Schools,03521,South Lyon High School,171,39,1012,1222
63240,South Lyon Community Schools,03522,Frank E. Bartlett School,82,26,265,373
63240,South Lyon Community Schools,07497,Centennial Middle School,130,43,634,807
63240,South Lyon Community Schools,07523,Millennium  Middle School,121,31,728,880
63240,South Lyon Community Schools,08801,William A. Brummer Elementary School,54,16,382,452
63240,South Lyon Community Schools,08894,Kent Lake Elementary School,94,26,467,587
63240,South Lyon Community Schools,09365,Sharon J. Hardy Elementary School,91,19,545,655
63240,South Lyon Community Schools,09415,South Lyon East High School,130,45,723,898
63250,Oak Park City School District,01097,Einstein Elementary School,247,30,198,475
63250,Oak Park City School District,01333,Roosevelt Middle School,312,28,116,456
63250,Oak Park City School District,02032,Key Elementary School,247,16,104,367
63250,Oak Park City School District,02166,Lessenger Elementary School,65,2,47,114
63250,Oak Park City School District,02798,Oak Park High School,626,59,475,1160
63250,Oak Park City School District,03006,Pepper Elementary School,235,22,129,386
63250,Oak Park City School District,04804,Oak Park Preparatory Academy,334,30,146,510
63260,Rochester Community School District,00178,Baldwin Elementary School,23,13,398,434
63260,Rochester Community School District,00410,Brooklands Elementary School,74,30,424,528
63260,Rochester Community School District,01114,Brewster Elementary School,13,7,343,363
63260,Rochester Community School District,01551,Hamlin Elementary School,144,24,355,523
63260,Rochester Community School District,01773,McGregor Elementary School,135,23,298,456
63260,Rochester Community School District,02498,Meadow Brook Elementary School,45,12,389,446
63260,Rochester Community School District,02731,North Hill Elementary School,55,19,546,620
63260,Rochester Community School District,03242,Rochester High School,248,80,1395,1723
63260,Rochester Community School District,04458,West Middle School,106,30,745,881
63260,Rochester Community School District,05239,Long Meadow Elementary School,45,10,536,591
63260,Rochester Community School District,05819,Rochester Adams High School,52,15,1434,1501
63260,Rochester Community School District,06270,University Hills Elem. School,32,5,364,401
63260,Rochester Community School District,06399,Reuther Middle School,162,42,517,721
63260,Rochester Community School District,06400,Van Hoosen Middle School,26,7,733,766
63260,Rochester Community School District,07103,Alternative Center for Education,35,3,48,86
63260,Rochester Community School District,07310,Hugger Elementary School,20,3,477,500
63260,Rochester Community School District,07350,Musson Elementary School,16,6,372,394
63260,Rochester Community School District,07548,Hart Middle School,114,25,1001,1140
63260,Rochester Community School District,07855,Hampton Elementary School,81,18,372,471
63260,Rochester Community School District,07864,Rochester Adult Education,18,0,73,91
63260,Rochester Community School District,09050,Stoney Creek High School,126,36,1543,1705
63260,Rochester Community School District,09051,Delta Kelly Elementary School,13,4,591,608
63270,Clawson Public Schools,00710,Clawson High School,155,61,351,567
63270,Clawson Public Schools,00711,Clawson Middle School,100,51,230,381
63270,Clawson Public Schools,02023,Kenwood Elementary School,60,27,199,286
63270,Clawson Public Schools,02978,Paul A. Schalm School,123,48,347,518
63280,Lamphere Public Schools,01089,Edmonson Elementary School,85,27,187,299
63280,Lamphere Public Schools,01682,Hiller Elementary School,278,29,104,411
63280,Lamphere Public Schools,01960,Page Middle School,241,42,322,605
63280,Lamphere Public Schools,02123,Lamphere High School,250,45,540,835
63280,Lamphere Public Schools,02168,Lessenger Elementary School,82,14,184,280
63280,Lamphere Public Schools,02639,Lamphere Center,56,1,23,80
63280,Lamphere Public Schools,03483,Simonds Elementary School,85,18,180,283
63290,Walled Lake Consolidated Schools,00721,Clifford H. Smart Middle School,97,36,813,946
63290,Walled Lake Consolidated Schools,00763,Commerce Elementary School,55,18,489,562
63290,Walled Lake Consolidated Schools,00889,Mary Helen Guest Elementary School,102,20,245,367
63290,Walled Lake Consolidated Schools,00961,Dublin Elementary,55,19,436,510
63290,Walled Lake Consolidated Schools,01420,Glengary Elementary School,58,12,371,441
63290,Walled Lake Consolidated Schools,02001,Keith Elementary School,56,10,556,622
63290,Walled Lake Consolidated Schools,02809,Oakley Park Elementary School,45,11,330,386
63290,Walled Lake Consolidated Schools,04235,Twin Beach Elementary,50,17,228,295
63290,Walled Lake Consolidated Schools,04339,James R Geisler Middle School,208,51,567,826
63290,Walled Lake Consolidated Schools,04340,Walled Lake Central High School,241,44,1443,1728
63290,Walled Lake Consolidated Schools,04341,Walled Lake Elementary School,116,21,275,412
63290,Walled Lake Consolidated Schools,04571,Wixom Elementary School,101,32,466,599
63290,Walled Lake Consolidated Schools,05705,Walled Lake Western High School,286,65,1219,1570
63290,Walled Lake Consolidated Schools,05706,Loon Lake Elementary School,71,30,374,475
63290,Walled Lake Consolidated Schools,06283,Maple Elementary School,86,17,376,479
63290,Walled Lake Consolidated Schools,07447,Pleasant Lake Elementary School,92,14,415,521
63290,Walled Lake Consolidated Schools,07544,Hickory Woods Elementary School,105,13,484,602
63290,Walled Lake Consolidated Schools,07792,Walled Lake Community Education Center,84,11,174,269
63290,Walled Lake Consolidated Schools,08577,Meadowbrook Elementary School,134,21,316,471
63290,Walled Lake Consolidated Schools,08610,Walnut Creek Middle School,145,24,730,899
63290,Walled Lake Consolidated Schools,08611,Sarah G. Banks Middle School,163,39,686,888
63290,Walled Lake Consolidated Schools,08995,Walled Lake Northern High School,141,34,1447,1622
63300,Waterford School District,00072,Waterford Alternative High School - Manley Campus,112,24,115,251
63300,Waterford School District,00522,Sandburg Elementary School,185,24,71,280
63300,Waterford School District,00933,Donelson Hills Elementary School,255,43,139,437
63300,Waterford School District,00946,Houghton Elementary School,120,20,256,396
63300,Waterford School District,01484,Grayson Elementary School,128,47,178,353
63300,Waterford School District,01857,Crary Middle School,277,76,343,696
63300,Waterford School District,01891,Adams Elementary School,72,16,296,384
63300,Waterford School District,01940,Pierce Middle School,284,87,562,933
63300,Waterford School District,02138,Haviland Elementary School,83,37,231,351
63300,Waterford School District,02803,Children's Village School,68,0,140,208
63300,Waterford School District,03220,Riverside Elementary School,149,41,187,377
63300,Waterford School District,03418,Schoolcraft Elementary School,109,35,300,444
63300,Waterford School District,04071,Mason Middle School,281,75,513,869
63300,Waterford School District,04092,Kingsley Montgomery School,88,5,57,150
63300,Waterford School District,04169,Cooley Elementary School,122,33,278,433
63300,Waterford School District,04393,Waterford Kettering High School,335,133,1137,1605
63300,Waterford School District,04395,Waterford Village Elementary School,122,54,144,320
63300,Waterford School District,04534,Burt Elementary School,194,25,166,385
63300,Waterford School District,04535,Beaumont Elementary School,140,35,215,390
63300,Waterford School District,05048,Knudsen Elementary School,140,24,203,367
63300,Waterford School District,05535,Waterford Mott High School,571,138,968,1677
63300,Waterford School District,07243,Stepanski Early Childhood Center,28,3,61,92
63300,Waterford School District,08408,Lutes Campus,14,0,34,48
63901,AGBU Alex-Marie Manoogian School,08265,AGBU Alex-Marie Manoogian School,157,0,211,368
63902,Academy of Oak Park,08291,Academy of Oak Park - High School,421,11,108,540
63902,Academy of Oak Park,08681,Academy of Oak Park - Elementary School,241,17,49,307
63902,Academy of Oak Park,09818,Academy of Oak Park - Middle School,217,0,17,234
63903,Academy of Southfield,08292,Academy of Southfield,231,41,57,329
63904,Academy of Lathrup Village,08293,Academy of Lathrup Village,283,29,54,366
63906,Pontiac Academy for Excellence,08433,Pontiac Academy for Excellence - High School,313,9,23,345
63906,Pontiac Academy for Excellence,09985,Pontiac Academy for Excellence - Middle School,302,0,66,368
63906,Pontiac Academy for Excellence,09986,Pontiac Academy for Excellence - Elementary,708,1,33,742
63907,Great Lakes Academy,08464,Great Lakes Academy,276,12,12,300
63910,Dr. Joseph F. Pollack Academic Center of Excellence,08702,Dr. Joseph F. Pollack Academic Center of Excellence,455,45,208,708
63911,Holly Academy,08734,Holly Academy,106,1,606,713
63912,Oakland International Academy,08743,Oakland International Academy - Middle/High School,188,4,2,194
63912,Oakland International Academy,09314,Oakland International Academy - Elementary,245,3,10,258
63912,Oakland International Academy,09830,Oakland International Academy-Intermediate,150,2,3,155
63913,Walton Charter Academy,08765,Walton Charter Academy,533,70,166,769
63914,Advanced Technology Academy,09910,Advanced Technology Academy,914,93,182,1189
63915,Arts and Technology Academy of Pontiac,08855,Arts and Technology Academy of Pontiac,326,21,26,373
63916,Academy of Waterford,09293,Academy of Waterford,190,25,20,235
63917,Bradford Academy,09292,Bradford Academy,814,153,505,1472
63918,Laurus Academy,09449,Laurus Academy,354,78,260,692
63919,Woodmont Academy,09454,Woodmont Academy,212,42,120,374
63920,Life Skills Center of Pontiac,09458,Life Skills Center of Pontiac,150,5,80,235
63921,Crescent Academy,09445,Crescent Academy,288,31,74,393
63922,Great Oaks Academy,09448,Great Oaks Academy,450,61,168,679
63923,Four Corners Montessori Academy,00117,Four Corners Montessori Academy,61,10,106,177
63924,Michigan Mathematics and Science Academy,00129,Michigan Mathematics and Science Academy,74,16,38,128
64000,Oceana Intermediate School District,07574,OISD Developmental Center,25,2,16,43
64040,Hart Public School District,01596,Hart High School,204,29,155,388
64040,Hart Public School District,01597,Hart Middle School,229,19,121,369
64040,Hart Public School District,03566,Spitler Elementary School,180,11,46,237
64040,Hart Public School District,08234,Hart Upper Elementary School,203,13,71,287
64070,Pentwater Public School District,03004,Pentwater Public School,112,45,108,265
64080,Shelby Public Schools,00280,Benona Elementary School,32,11,42,85
64080,Shelby Public Schools,02681,New Era Elementary School,43,18,35,96
64080,Shelby Public Schools,03454,Shelby High School,210,49,263,522
64080,Shelby Public Schools,03455,Shelby Middle School,172,31,116,319
64080,Shelby Public Schools,04170,Thomas Read Elementary School,253,31,52,336
64080,Shelby Public Schools,07215,Oceana High School,83,8,20,111
64080,Shelby Public Schools,09002,Oceana Community Education,17,0,20,37
64080,Shelby Public Schools,09895,Early Childhood Center,96,15,28,139
64080,Shelby Public Schools,09903,Alpha House,4,0,8,12
64090,Walkerville Public Schools,04336,Walkerville High School,74,1,20,95
64090,Walkerville Public Schools,04817,Walkerville Elementary School,135,9,21,165
64090,Walkerville Public Schools,09978,Walkerville Middle School,64,1,13,78
65045,West Branch-Rose City Area Schools,03287,Rose City Elementary School,101,33,35,169
65045,West Branch-Rose City Area Schools,03789,Surline Middle School,237,51,236,524
65045,West Branch-Rose City Area Schools,04438,Ogemaw Heights High School,302,88,436,826
65045,West Branch-Rose City Area Schools,05838,Surline Elementary School,294,61,274,629
65045,West Branch-Rose City Area Schools,08886,Rose City Middle School,89,20,42,151
65045,West Branch-Rose City Area Schools,09597,OHHS Credit Recovery Program,11,0,5,16
66045,Ewen-Trout Creek Consolidated School District,01175,Ewen-Trout Creek Consolidated School,112,42,103,257
66050,Ontonagon Area Schools,02835,Ontonagon Area Elementary School,70,31,101,202
66050,Ontonagon Area Schools,06170,Ontonagon Area Jr/Sr High School,77,38,201,316
67020,Evart Public Schools,01164,Evart Elementary School,227,51,115,393
67020,Evart Public Schools,01165,Evart High School,162,22,166,350
67020,Evart Public Schools,07673,Evart Alternative High School,39,2,10,51
67020,Evart Public Schools,08496,Evart Middle School,172,30,85,287
67050,Marion Public Schools,02378,Marion High School,141,23,106,270
67050,Marion Public Schools,05258,Marion Elementary School,169,16,101,286
67055,Pine River Area Schools,03047,Pine River High School,186,31,225,442
67055,Pine River Area Schools,05232,Leroy Elementary School,130,24,78,232
67055,Pine River Area Schools,05246,Luther Elementary School,69,13,27,109
67055,Pine River Area Schools,05350,Tustin Elementary School,104,23,68,195
67055,Pine River Area Schools,09070,Pine River Middle School,136,33,109,278
67060,Reed City Area Public Schools,03170,G.T. Norman Elementary School,332,73,279,684
67060,Reed City Area Public Schools,03171,Reed City High School,172,37,299,508
67060,Reed City Area Public Schools,03172,Reed City Middle School,159,37,170,366
67060,Reed City Area Public Schools,07707,Reed City Alt. Ed. Program,15,4,4,23
68010,Mio-AuSable Schools,02580,Mio-AuSable Elementary School,195,18,95,308
68010,Mio-AuSable Schools,02581,Mio-AuSable High School,197,41,137,375
68030,Fairview Area School District,01178,Fairview Elementary School,79,17,45,141
68030,Fairview Area School District,01194,Fairview High School,89,19,74,182
69020,Gaylord Community Schools,01374,Gaylord Middle School,168,38,286,492
69020,Gaylord Community Schools,01375,Gaylord High School/Voc. Bldg.,316,69,653,1038
69020,Gaylord Community Schools,06125,North Ohio Elementary School,234,27,173,434
69020,Gaylord Community Schools,06126,South Maple Elementary School,236,30,231,497
69020,Gaylord Community Schools,07965,Gaylord Intermediate School,303,48,364,715
69020,Gaylord Community Schools,08481,Gaylord Academic Support Center,36,8,4,48
69030,Johannesburg-Lewiston Area Schools,01935,Johannesburg-Lewiston High School,76,25,123,224
69030,Johannesburg-Lewiston Area Schools,02174,Lewiston Elementary-Middle School,187,37,119,343
69030,Johannesburg-Lewiston Area Schools,05867,Johannesburg Elementary/Middle School,74,22,134,230
69040,Vanderbilt Area Schools,05868,Vanderbilt Area School,94,15,53,162
70000,Ottawa Area ISD,01054,Ottawa Area Center,136,13,103,252
70000,Ottawa Area ISD,07294,Sheldon Pines School,13,2,7,22
70000,Ottawa Area ISD,09640,Juvenile Services Center,17,0,16,33
70010,Grand Haven Area Public Schools,00620,Central High School,55,13,47,115
70010,Grand Haven Area Public Schools,01227,Ferry School,133,43,136,312
70010,Grand Haven Area Public Schools,01454,White Pines Middle School,199,90,474,763
70010,Grand Haven Area Public Schools,01455,Grand Haven High School,350,158,1286,1794
70010,Grand Haven Area Public Schools,02407,Mary A. White School,95,18,197,310
70010,Grand Haven Area Public Schools,02985,Peach Plains School,47,35,401,483
70010,Grand Haven Area Public Schools,03240,Robinson School,120,56,224,400
70010,Grand Haven Area Public Schools,03297,Rosy Mound School,40,18,332,390
70010,Grand Haven Area Public Schools,05154,Griffin Elementary School,114,44,222,380
70010,Grand Haven Area Public Schools,06271,Lake Hills Elementary School,118,28,168,314
70010,Grand Haven Area Public Schools,08457,Lakeshore Middle School,140,62,392,594
70020,Holland City School District,01697,Holland High School,698,87,637,1422
70020,Holland City School District,07577,East,497,48,196,741
70020,Holland City School District,09275,Holland Heights,262,13,90,365
70020,Holland City School District,09962,Van Raalte,126,2,64,192
70020,Holland City School District,09963,Maplewood,18,1,12,31
70020,Holland City School District,09964,West,362,37,306,705
70020,Holland City School District,09965,Jefferson,384,72,134,590
70040,Allendale Public School District,00069,Evergreen Elementary,97,34,255,386
70040,Allendale Public School District,05889,Allendale High School,106,40,457,603
70040,Allendale Public School District,07293,New Options Alternative High School,23,3,9,35
70040,Allendale Public School District,08164,Allendale Middle School,98,36,328,462
70040,Allendale Public School District,08662,Springview Elementary,93,30,266,389
70040,Allendale Public School District,09937,Oakwood Intermediate,80,26,225,331
70070,West Ottawa Public School District,01428,Glerum Elementary School,181,48,62,291
70070,West Ottawa Public School District,02114,Lakewood Elementary School,74,21,330,425
70070,West Ottawa Public School District,02732,North Holland Elementary School,125,42,103,270
70070,West Ottawa Public School District,03458,Sheldon Woods Elementary School,70,14,76,160
70070,West Ottawa Public School District,04401,Waukazoo Elementary School,70,20,422,512
70070,West Ottawa Public School District,04462,West Ottawa High School Campus,767,198,1375,2340
70070,West Ottawa Public School District,04595,Woodside Elementary School,357,40,157,554
70070,West Ottawa Public School District,06296,Macatawa Bay Middle School,309,74,379,762
70070,West Ottawa Public School District,07519,Pine Creek Elementary School,236,41,74,351
70070,West Ottawa Public School District,07840,Lakeshore Elementary School,136,24,218,378
70070,West Ottawa Public School District,08612,Great Lakes Elementary School,323,61,172,556
70070,West Ottawa Public School District,08613,Harbor Lights Middle School,380,98,529,1007
70120,Coopersville Area Public School District,00793,Coopersville West Early Childhood Center,84,15,126,225
70120,Coopersville Area Public School District,00794,Coopersville High School,161,58,604,823
70120,Coopersville Area Public School District,00795,Coopersville South Elementary School,173,46,343,562
70120,Coopersville Area Public School District,04802,Coopersville Middle School,159,32,368,559
70120,Coopersville Area Public School District,09699,New Options High School,27,1,17,45
70120,Coopersville Area Public School District,09939,Coopersville East Elementary,131,23,181,335
70175,Jenison Public Schools,00225,Bauerwood School,82,35,421,538
70175,Jenison Public Schools,00462,Bursley School,100,30,236,366
70175,Jenison Public Schools,01920,Jenison Junior High School,111,55,507,673
70175,Jenison Public Schools,03401,Sandy Hill School,117,35,289,441
70175,Jenison Public Schools,05740,Pinewood School,72,31,264,367
70175,Jenison Public Schools,06127,Jenison High School,201,93,1282,1576
70175,Jenison Public Schools,06169,Rosewood School,80,37,365,482
70175,Jenison Public Schools,09405,Jenison Public Schools Early Childhood Center,48,8,105,161
70190,Hudsonville Public School District,00079,Alward Elementary School,52,34,370,456
70190,Hudsonville Public School District,00224,Bauer Elementary School,47,21,280,348
70190,Hudsonville Public School District,01263,Forest Grove Elementary School,50,7,209,266
70190,Hudsonville Public School District,01784,Hudsonville Freshman Campus,73,43,318,434
70190,Hudsonville Public School District,01785,Hudsonville High School,128,66,958,1152
70190,Hudsonville Public School District,01787,Park Elemementary School,57,37,275,369
70190,Hudsonville Public School District,01886,Jamestown Elementary School,95,39,341,475
70190,Hudsonville Public School District,03510,South Elementary School,117,28,218,363
70190,Hudsonville Public School District,08384,Baldwin Street Middle School,100,40,655,795
70190,Hudsonville Public School District,08805,Riley Street Middle School,109,40,323,472
70190,Hudsonville Public School District,09644,Georgetown Elementary School,40,37,462,539
70300,Spring Lake Public Schools,01704,Holmes Elementary School,63,20,400,483
70300,Spring Lake Public Schools,01892,Jeffers Elementary School,55,16,327,398
70300,Spring Lake Public Schools,03567,Spring Lake High School,90,36,699,825
70300,Spring Lake Public Schools,08824,Spring Lake Middle School,47,18,272,337
70300,Spring Lake Public Schools,08825,Spring Lake Intermediate School,54,14,265,333
70300,Spring Lake Public Schools,09068,Spring Lake Alternative Education,11,0,11,22
70350,Zeeland Public Schools,02196,Lincoln Elementary School,101,33,266,400
70350,Zeeland Public Schools,02682,New Groningen School,67,35,281,383
70350,Zeeland Public Schools,03265,Roosevelt Elementary School,115,50,190,355
70350,Zeeland Public Schools,04622,Creekside Middle School,113,43,304,460
70350,Zeeland Public Schools,04623,Zeeland East High School,144,60,856,1060
70350,Zeeland Public Schools,07308,Early Childhood Center,61,30,237,328
70350,Zeeland Public Schools,08233,Woodbridge Elementary School,102,34,323,459
70350,Zeeland Public Schools,08350,Cityside Middle School,121,79,556,756
70350,Zeeland Public Schools,08994,Zeeland Adult Education Center,7,0,16,23
70350,Zeeland Public Schools,09057,Zeeland West High School,128,58,526,712
70350,Zeeland Public Schools,09129,Summit School,6,4,19,29
70350,Zeeland Public Schools,09373,Quincy Elementary School,95,46,388,529
70350,Zeeland Public Schools,09755,Innocademy,24,2,104,130
70901,Walden Green Montessori,08212,Walden Green Montessori,51,0,190,241
70902,West MI Academy of Arts and Academics,08332,W. Mich Academy of Arts and Academics,88,18,286,392
70904,Black River Public School,08331,Black River Public School,96,37,697,830
70905,Vanderbilt Charter Academy,08372,Vanderbilt Charter Academy,270,68,105,443
70906,Eagle Crest Charter Academy,08516,Eagle Crest Charter Academy,186,104,424,714
70907,Wavecrest Career Academy,09700,Wavecrest Career Academy,88,2,73,163
71050,Onaway Area Community School District,02829,Onaway Elementary School,172,35,110,317
71050,Onaway Area Community School District,02830,Onaway Senior High School,87,21,103,211
71050,Onaway Area Community School District,08646,Onaway Middle School,85,19,71,175
71060,Posen Consolidated School District,04655,Posen Consolidated High School,40,19,70,129
71060,Posen Consolidated School District,04656,Posen Elementary School,46,31,43,120
71080,Rogers City Area Schools,03252,Rogers City High School,95,34,193,322
71080,Rogers City Area Schools,03255,Rogers City Elementary School,106,29,98,233
71902,Presque Isle Academy II,08867,Presque Isle Academy II,39,4,16,59
72000,C.O.O.R. ISD,07995,C.O.O.R. Special Educational Center,46,11,23,80
72010,Roscommon Area Public Schools,01396,Roscommon Elementary School,172,30,156,358
72010,Roscommon Area Public Schools,03722,St. Helen Elementary School,132,2,20,154
72010,Roscommon Area Public Schools,05115,Roscommon High School,255,51,223,529
72010,Roscommon Area Public Schools,06369,Roscommon Middle School,264,40,182,486
72020,Houghton Lake Community Schools,00750,Collins Elementary School,291,24,109,424
72020,Houghton Lake Community Schools,01769,Houghton Lake High School,329,71,273,673
72020,Houghton Lake Community Schools,06930,Houghton Lake Middle School,280,35,127,442
72020,Houghton Lake Community Schools,08258,Houghton Lake Adult Education,61,4,28,93
72020,Houghton Lake Community Schools,08537,Second Chance Academy,17,0,7,24
73000,Saginaw ISD,07016,Saginaw County Juvenile Center,95,0,0,95
73000,Saginaw ISD,07038,M.G. Millet Learning Center,163,13,105,281
73000,Saginaw ISD,08777,Michael J McGivney,11,0,47,58
73000,Saginaw ISD,08905,Saginaw ISD Transitions Center,21,1,6,28
73010,Saginaw City School District,00125,Arthur Hill High School,916,86,302,1304
73010,Saginaw City School District,00606,Ruben Daniels Middle School,432,11,38,481
73010,Saginaw City School District,00667,Chester F. Miller School,197,27,51,275
73010,Saginaw City School District,01558,Handley School,79,23,324,426
73010,Saginaw City School District,01618,Heavenrich School,272,12,11,295
73010,Saginaw City School District,01645,Herig School,328,20,21,369
73010,Saginaw City School District,01767,Houghton Elementary School,222,4,6,232
73010,Saginaw City School District,01926,Jerome School,199,13,8,220
73010,Saginaw City School District,01929,Jessie Loomis School,321,7,20,348
73010,Saginaw City School District,01930,Jessie Rouse School,241,3,5,249
73010,Saginaw City School District,02010,Kempton Elementary School,228,34,113,375
73010,Saginaw City School District,02253,Longfellow School,244,7,9,260
73010,Saginaw City School District,02521,Merrill Park Elementary School,265,16,17,298
73010,Saginaw City School District,03336,Saginaw High School,619,22,161,802
73010,Saginaw City School District,03532,Thompson Middle School,627,40,72,739
73010,Saginaw City School District,04083,Stone School,219,12,9,240
73010,Saginaw City School District,04624,Zilwaukee K-8 School,162,27,97,286
73010,Saginaw City School District,05650,C.C. Coulter Elementary School,133,0,4,137
73010,Saginaw City School District,06246,Career Opportunities Center,209,0,416,625
73010,Saginaw City School District,06415,Hillier Educational Center,17,0,14,31
73010,Saginaw City School District,08753,Saginaw Arts and Sciences Academy,173,42,478,693
73010,Saginaw City School District,09101,Arthur Eddy K-8 Academy,312,31,27,370
73010,Saginaw City School District,09349,Ruben Daniels Community School-ETC,162,0,85,247
73030,Carrollton School District,00536,Carrollton High School,222,66,221,509
73030,Carrollton School District,05141,Carrollton Elementary School,485,50,133,668
73030,Carrollton School District,08409,Carrollton Middle School,244,36,122,402
73030,Carrollton School District,09242,Omni Adult and Alternative Education,94,9,30,133
73030,Carrollton School District,09375,Post Secondary Transition,166,2,32,200
73040,Saginaw Township Community Schools,00942,White Pine Middle School,364,71,733,1168
73040,Saginaw Township Community Schools,01626,Hemmeter Elementary School,45,15,343,403
73040,Saginaw Township Community Schools,03063,Plainfield Elementary School,152,34,77,263
73040,Saginaw Township Community Schools,04425,Weiss Elementary School,95,18,173,286
73040,Saginaw Township Community Schools,04475,Westdale Elementary School,188,30,93,311
73040,Saginaw Township Community Schools,04954,Arrowwood Elementary School,106,38,260,404
73040,Saginaw Township Community Schools,05158,Heritage High School,422,87,1285,1794
73040,Saginaw Township Community Schools,05407,Sherwood Elementary School,132,22,306,460
73040,Saginaw Township Community Schools,08178,Mackinaw Academy,139,10,96,245
73080,Buena Vista School District,00440,Buena Vista High School,323,15,50,388
73080,Buena Vista School District,00479,Brunkow Elementary School,181,1,18,200
73080,Buena Vista School District,01628,Henry Doerr CDC,118,7,11,136
73080,Buena Vista School District,03196,Ricker Middle School,171,1,14,186
73080,Buena Vista School District,08693,Wolverine Secure Treatment Center,96,0,10,106
73110,Chesaning Union Schools,00041,Albee Elementary School,86,12,43,141
73110,Chesaning Union Schools,00379,Brady Elementary School,89,10,64,163
73110,Chesaning Union Schools,00666,Chesaning Union High School,168,53,345,566
73110,Chesaning Union Schools,05592,Big Rock Elementary School,139,21,177,337
73110,Chesaning Union Schools,06774,Chesaning Middle School,199,45,309,553
73170,Birch Run Area School District,00327,Birch Run High School,137,55,382,574
73170,Birch Run Area School District,02737,North Elementary School,225,68,351,644
73170,Birch Run Area School District,06942,Marshall Greene Middle School,209,54,324,587
73170,Birch Run Area School District,09779,Birch Run Alternative High School,21,2,19,42
73180,Bridgeport-Spaulding Community School District,00398,Bridgeport High School,306,22,221,549
73180,Bridgeport-Spaulding Community School District,04173,Thomas White School,157,7,37,201
73180,Bridgeport-Spaulding Community School District,06585,Bridgeport-Spaulding Middle School-Schrah,160,20,78,258
73180,Bridgeport-Spaulding Community School District,09552,Martin G. Atkins Elementary School,382,34,126,542
73190,Frankenmuth School District,01297,Frankenmuth High School,43,14,487,544
73190,Frankenmuth School District,02263,Lorenz C. List School,43,11,297,351
73190,Frankenmuth School District,05252,E.F. Rittmueller Middle School,47,9,277,333
73200,Freeland Community School District,01318,Freeland Learning Center,59,7,326,392
73200,Freeland Community School District,01319,Freeland Middle School/High School,116,26,729,871
73200,Freeland Community School District,04861,Freeland Elementary School,74,18,437,529
73210,Hemlock Public School District,01624,Hemlock Elementary School,60,11,194,265
73210,Hemlock Public School District,01625,Hemlock High School,79,14,392,485
73210,Hemlock Public School District,03895,K.C. Ling Elementary School,64,13,198,275
73210,Hemlock Public School District,05152,Hemlock Middle School,76,11,222,309
73210,Hemlock Public School District,09668,Hemlock Alternative/Adult Education,4,0,21,25
73230,Merrill Community Schools,02519,Merrill High School,78,16,168,262
73230,Merrill Community Schools,02520,Merrill Elementary School,156,29,154,339
73230,Merrill Community Schools,06222,Merrill Middle School,73,19,85,177
73240,St. Charles Community Schools,03659,St. Charles Community High School,93,36,240,369
73240,St. Charles Community Schools,05693,Anna M. Thurston Middle School,93,22,129,244
73240,St. Charles Community Schools,07810,St. Charles Alternative Education,14,2,7,23
73240,St. Charles Community Schools,09663,St. Charles Elementary School,190,52,243,485
73255,Swan Valley School District,04887,Shields Elementary School,113,41,243,397
73255,Swan Valley School District,05856,Swan Valley Middle School,103,43,284,430
73255,Swan Valley School District,06128,Robert B. Havens Elem. School,84,29,191,304
73255,Swan Valley School District,06233,Swan Valley High School,124,53,459,636
73255,Swan Valley School District,09484,Swan Valley Adult and Alternative Education,11,0,23,34
73905,Saginaw County Transition Academy,08284,Saginaw County Transition Academy,124,0,5,129
73908,Saginaw Preparatory Academy,08519,Saginaw Preparatory Academy,292,17,11,320
73909,Francis Reh PSA,08653,Francis Reh PSA,323,10,11,344
73910,North Saginaw Charter Academy,08740,North Saginaw Charter Academy,365,47,120,532
73911,Saginaw Learn to Earn Academy,09601,Saginaw Learn to Earn Academy,94,6,26,126
73912,International Academy of Saginaw,09784,International Academy of Saginaw,183,13,37,233
74000,St. Clair County RESA,03376,Woodland Developmental Center,92,10,67,169
74010,Port Huron Area School District,00676,Chippewa Middle School,225,32,234,491
74010,Port Huron Area School District,00719,Cleveland Elementary School,210,9,13,232
74010,Port Huron Area School District,01272,Fort Gratiot Middle School,164,32,479,675
74010,Port Huron Area School District,01366,Garfield Elementary School,334,32,140,506
74010,Port Huron Area School District,01772,H.D. Crull Elementary School,371,30,180,581
74010,Port Huron Area School District,01999,Keewahdin Elementary School,125,19,302,446
74010,Port Huron Area School District,02033,Kimball Elementary School,238,36,168,442
74010,Port Huron Area School District,02092,Lakeport Elementary School,119,12,137,268
74010,Port Huron Area School District,02538,Michigamme Elementary School,173,17,276,466
74010,Port Huron Area School District,02640,Grant Educational Center,121,0,134,255
74010,Port Huron Area School District,03090,Port Huron Northern High School,454,75,948,1477
74010,Port Huron Area School District,03091,Central Middle School,444,64,195,703
74010,Port Huron Area School District,03092,Port Huron High School,747,130,793,1670
74010,Port Huron Area School District,03285,Roosevelt Elementary School,348,39,140,527
74010,Port Huron Area School District,04160,Edison Elementary School,75,13,332,420
74010,Port Huron Area School District,04237,Holland Woods Middle School,242,23,162,427
74010,Port Huron Area School District,04588,Woodrow Wilson Elementary School,430,30,37,497
74010,Port Huron Area School District,06775,Indian Woods Elementary School,117,24,260,401
74030,Algonac Community School District,00053,Algonac Elementary School,171,38,155,364
74030,Algonac Community School District,00054,Algonac High School,195,44,431,670
74030,Algonac Community School District,01053,Algonquin Middle School,173,45,267,485
74030,Algonac Community School District,01179,Fair Haven Elementary School,70,11,142,223
74030,Algonac Community School District,07827,Millside Elementary School,95,20,174,289
74040,Capac Community School District,00518,Capac Elementary School,218,52,267,537
74040,Capac Community School District,00519,Capac High School,196,74,405,675
74040,Capac Community School District,00521,Capac Middle School,128,42,181,351
74040,Capac Community School District,07820,Capac Adult and Community Education,16,1,13,30
74050,East China School District,01051,Pine River Elementary School,91,16,332,439
74050,East China School District,01433,Belle River Elementary School,175,45,208,428
74050,East China School District,02120,Gearing Elementary School,92,14,222,328
74050,East China School District,02375,Marine City Middle School,144,43,303,490
74050,East China School District,02376,Marine City High School,201,32,558,791
74050,East China School District,02934,Palms Elementary School,58,19,205,282
74050,East China School District,03664,St. Clair High School,162,50,792,1004
74050,East China School District,03665,St. Clair Middle School,151,52,468,671
74050,East China School District,04153,Theo V. Eddy Elementary School,150,16,280,446
74050,East China School District,08924,Riverview East High School,75,4,110,189
74100,Marysville Public Schools,02414,Marysville Middle School,124,31,492,647
74100,Marysville Public Schools,02416,Marysville High School,119,26,623,768
74100,Marysville Public Schools,02418,Washington Elementary School,123,25,297,445
74100,Marysville Public Schools,02419,Gardens Elementary School,81,16,397,494
74100,Marysville Public Schools,08355,Morton Elementary School,96,14,211,321
74120,Memphis Community Schools,02510,Memphis Junior High School,57,28,162,247
74120,Memphis Community Schools,05673,Memphis High School,90,39,224,353
74120,Memphis Community Schools,06672,Memphis Elementary School,136,36,284,456
74130,Yale Public Schools,00157,Avoca Elementary School,103,15,161,279
74130,Yale Public Schools,02894,John F. Farrell-Emmett Elementary School,67,25,172,264
74130,Yale Public Schools,04607,Yale Elementary School,147,37,224,408
74130,Yale Public Schools,04613,Yale Senior High School,170,66,480,716
74130,Yale Public Schools,06339,Yale Junior High School,176,30,329,535
74130,Yale Public Schools,07528,Phoenix Alternative School,11,0,13,24
74901,St. Clair County Learning Academy,08307,St. Clair County Learning Academy,25,2,5,32
74902,Industrial Technology Academy,08418,Industrial Technology Academy,1,0,0,1
74903,Landmark Academy,08701,Landmark Academy,310,94,498,902
74906,Blue Water Learning Academy,08819,Blue Water Learning Academy,18,2,7,27
74908,Academic Transitional Academy,09259,Academic Transitional Academy,2,0,0,2
74909,Public Safety Academy of St. Clair,09260,Public Safety Academy of St. Clair,0,0,1,1
74911,St. Clair County Intervention Academy,09455,St. Clair County Intervention Academy,73,0,0,73
74912,Virtual Learning Academy of St. Clair County,00195,Virtual Learning Academyof St. Clair County,85,5,14,104
75000,St. Joseph County ISD,01037,Pathfinder Center,71,9,48,128
75010,Sturgis Public Schools,00604,Sturgis Middle School,384,75,240,699
75010,Sturgis Public Schools,00771,Congress School,152,21,96,269
75010,Sturgis Public Schools,01924,Jerolene School,9,0,4,13
75010,Sturgis Public Schools,04095,Sturgis High School,412,80,496,988
75010,Sturgis Public Schools,04337,Wall School,264,36,87,387
75010,Sturgis Public Schools,04434,Wenzel School,124,10,15,149
75010,Sturgis Public Schools,07988,Eastwood School,445,59,210,714
75010,Sturgis Public Schools,08919,Sturgis Schools Adult Education Center,20,0,44,64
75020,Burr Oak Community School District,00458,Burr Oak Elementary School,128,4,68,200
75020,Burr Oak Community School District,00459,Burr Oak High School,63,3,33,99
75030,Centreville Public Schools,00626,Centreville Middle School,57,15,67,139
75030,Centreville Public Schools,00627,Centreville High School,91,32,174,297
75030,Centreville Public Schools,00628,Centreville Elementary School,184,52,244,480
75030,Centreville Public Schools,08410,Covered Bridge School,21,2,14,37
75040,Colon Community School District,00755,Colon Elementary School,180,20,142,342
75040,Colon Community School District,05036,Colon High School,121,23,151,295
75040,Colon Community School District,05231,Leonidas School,45,10,1,56
75050,Constantine Public School District,00775,Constantine High School,184,33,244,461
75050,Constantine Public School District,00776,Constantine Middle School,154,18,144,316
75050,Constantine Public School District,01036,Eastside Elementary School,211,36,146,393
75050,Constantine Public School District,03213,Riverside Elementary School,178,30,112,320
75050,Constantine Public School District,09922,Constantine Alternative Education,41,3,19,63
75060,Mendon Community School District,02511,Mendon Middle/High School,129,31,243,403
75060,Mendon Community School District,02512,Mendon Elementary School,124,36,141,301
75070,White Pigeon Community Schools,04502,White Pigeon Jr/Sr High School,210,43,186,439
75070,White Pigeon Community Schools,04503,Central Elementary School,231,38,117,386
75080,Three Rivers Community Schools,00336,Andrews Elementary School,215,30,98,343
75080,Three Rivers Community Schools,03301,Ruth Hoppin School,145,27,131,303
75080,Three Rivers Community Schools,04181,Three Rivers High School,305,48,472,825
75080,Three Rivers Community Schools,05217,Norton Elementary School,147,8,121,276
75080,Three Rivers Community Schools,05336,Park Elementary School,228,30,140,398
75080,Three Rivers Community Schools,06272,Three Rivers Middle School,302,55,267,624
75080,Three Rivers Community Schools,07698,Barrows Adult Education,28,1,20,49
75100,Nottawa Community School,02787,Nottawa Community School,55,25,70,150
76000,Sanilac ISD,06548,Sanilac Career Center,0,0,1,1
76000,Sanilac ISD,08852,Sanilac ISD Special Education Services,74,9,62,145
76060,Brown City Community Schools,00421,Brown City High School,157,53,233,443
76060,Brown City Community Schools,06165,Brown City Elementary School,242,68,204,514
76060,Brown City Community Schools,07905,Brown City Alternative H.S.,24,2,17,43
76070,Carsonville-Port Sanilac School District,00540,Carsonville-Port Sanilac Elementary School,181,28,82,291
76070,Carsonville-Port Sanilac School District,00541,Carsonville-Port Sanilac H.S.,122,17,137,276
76070,Carsonville-Port Sanilac School District,09548,Carsonville-Port Sanilac Learning Center,46,3,24,73
76080,Croswell-Lexington Community Schools,00840,Geiger Early Childhood Center,16,2,14,32
76080,Croswell-Lexington Community Schools,00841,Croswell-Lexington High School,280,73,390,743
76080,Croswell-Lexington Community Schools,01335,Frostick School,208,40,159,407
76080,Croswell-Lexington Community Schools,02533,Meyer Elementary School,159,38,166,363
76080,Croswell-Lexington Community Schools,06389,Croswell-Lexington Middle School,290,72,330,692
76090,Deckerville Community School District,00890,Deckerville Elementary School,169,36,135,340
76090,Deckerville Community School District,00891,Deckerville Community High School,139,20,161,320
76140,Marlette Community Schools,00230,Marlette Elementary,271,74,210,555
76140,Marlette Community Schools,02385,Marlette Jr./Sr. High School,203,49,285,537
76140,Marlette Community Schools,09432,Marlette Learning Center,16,0,9,25
76180,Peck Community School District,05344,Peck Community Elem. School,140,39,112,291
76180,Peck Community School District,05345,Peck Jr./Sr. High School,97,40,124,261
76210,Sandusky Community School District,02355,Maple Valley Elementary School,192,61,168,421
76210,Sandusky Community School District,03400,Sandusky High School,137,35,217,389
76210,Sandusky Community School District,05398,Sandusky Middle School,145,43,153,341
76210,Sandusky Community School District,09929,Sandusky Alternative School,5,1,2,8
77010,Manistique Area Schools,02340,Manistique Middle and High School,174,70,321,565
77010,Manistique Area Schools,05219,Emerald Elementary School,189,36,162,387
77010,Manistique Area Schools,08521,Manistique Alternative Ed Center,23,5,7,35
78000,Shiawassee Regional ESD,01035,Shiawassee RESD - Student Learning Center - West,81,12,56,149
78000,Shiawassee Regional ESD,09016,Shiawassee RESD - Student Learning Center - East,14,0,31,45
78020,Byron Area Schools,00472,Byron Area High School,95,40,262,397
78020,Byron Area Schools,00473,Byron Area Elementary School,166,55,337,558
78020,Byron Area Schools,06402,Byron Area Middle School,83,38,167,288
78030,Durand Area Schools,00185,Wilbur Bills Elementary School,54,17,79,150
78030,Durand Area Schools,00301,Bertha Neal School,74,15,103,192
78030,Durand Area Schools,00952,Doyle Knight School,105,13,86,204
78030,Durand Area Schools,00972,Durand Area High School,199,50,333,582
78030,Durand Area Schools,00973,Durand Middle School,172,41,194,407
78030,Durand Area Schools,03234,Robert Kerr School,104,15,102,221
78040,Laingsburg Community School District,02070,Laingsburg Elementary School,105,15,394,514
78040,Laingsburg Community School District,02071,Laingsburg High School,55,24,373,452
78040,Laingsburg Community School District,06302,Laingsburg Middle School,52,20,205,277
78060,Morrice Area Schools,02614,Morrice Area Elementary School,117,14,157,288
78060,Morrice Area Schools,02615,Morrice Area High School,75,23,175,273
78070,New Lothrop Area Public Schools,02685,New Lothrop High School,57,11,284,352
78070,New Lothrop Area Public Schools,03716,New Lothrop Elementary School,103,24,361,488
78080,Perry Public School District,03012,Perry East Elementary,182,54,224,460
78080,Perry Public School District,03013,Perry High School,132,36,361,529
78080,Perry Public School District,05403,Perry West Elementary,125,16,164,305
78080,Perry Public School District,06029,Perry Middle School,117,35,241,393
78080,Perry Public School District,09747,Alternative/Adult Education (Administration Building),41,0,35,76
78100,Corunna Public School District,00806,Corunna Middle School,214,64,308,586
78100,Corunna Public School District,01128,Elsa Meyer Elementary School,202,28,182,412
78100,Corunna Public School District,02267,Louise Peacock Elementary School,120,37,193,350
78100,Corunna Public School District,02674,Nellie Reed Elementary School,114,25,148,287
78100,Corunna Public School District,06673,Corunna High School,226,57,524,807
78110,Owosso Public Schools,00434,Bryant School,311,34,101,446
78110,Owosso Public Schools,00611,Central School,134,23,216,373
78110,Owosso Public Schools,01142,Emerson School,325,27,232,584
78110,Owosso Public Schools,02920,Owosso Middle School,232,36,237,505
78110,Owosso Public Schools,02924,Owosso High School,391,80,603,1074
78110,Owosso Public Schools,04367,Washington School,177,26,135,338
78110,Owosso Public Schools,09543,Lincoln Alternative High School,117,13,52,182
79000,Tuscola ISD,00000,RESA/ISD students attending LEA school--79000,120,0,4,124
79000,Tuscola ISD,01997,Highland Pines School,125,17,67,209
79000,Tuscola ISD,09353,Bridges Assessment Center,4,0,0,4
79000,Tuscola ISD,09354,Bridges Assessment Center Residential,17,0,0,17
79010,Akron-Fairgrove Schools,00033,Akron-Fairgrove Elem. School,87,19,47,153
79010,Akron-Fairgrove Schools,00034,Akron-Fairgrove Jr/Sr High School,91,22,56,169
79020,Caro Community Schools,00528,Schall Elementary School,171,36,189,396
79020,Caro Community Schools,00529,Caro High School,203,63,368,634
79020,Caro Community Schools,04973,McComb Elementary School,224,53,175,452
79020,Caro Community Schools,06416,Caro Middle School,175,48,248,471
79020,Caro Community Schools,07809,Caro Alternative Education,17,4,16,37
79030,Cass City Public Schools,00509,Campbell Elementary School,193,57,189,439
79030,Cass City Public Schools,00552,Cass City High School,145,46,233,424
79030,Cass City Public Schools,05011,Cass City Middle School,159,37,145,341
79030,Cass City Public Schools,09568,Transition Center,5,0,12,17
79080,Kingston Community School District,02042,Kingston High School,105,33,144,282
79080,Kingston Community School District,02043,Kingston Elementary School,192,35,112,339
79090,Mayville Community School District,02452,Mayville High School,151,31,125,307
79090,Mayville Community School District,02453,Mayville Elementary School,209,31,129,369
79090,Mayville Community School District,05807,Mayville Middle School,125,21,73,219
79100,Millington Community Schools,02570,Millington High School,177,53,346,576
79100,Millington Community Schools,05276,Kirk Elementary School,207,54,198,459
79100,Millington Community Schools,06450,Meachum Junior High School,156,57,201,414
79100,Millington Community Schools,09628,Glaza Building,16,0,29,45
79110,Reese Public Schools,03173,Reese High School,95,14,280,389
79110,Reese Public Schools,05372,Reese Elementary School,158,18,141,317
79110,Reese Public Schools,06674,Reese Middle School,109,17,157,283
79145,Unionville-Sebewaing Area S.D.,03431,Unionville-Sebewaing Middle School,77,29,182,288
79145,Unionville-Sebewaing Area S.D.,04255,Unionville-Sebewaing High School,62,31,197,290
79145,Unionville-Sebewaing Area S.D.,04909,Unionville-Sebewaing Elem. School,122,35,212,369
79150,Vassar Public Schools,00612,Central School,182,51,151,384
79150,Vassar Public Schools,04195,Townsend North School,156,37,117,310
79150,Vassar Public Schools,04287,Vassar Senior High School,153,68,270,491
79150,Vassar Public Schools,04846,Vassar Junior High School,97,32,86,215
79150,Vassar Public Schools,07857,Pioneer Work and Learn Center,313,0,6,319
80000,Van Buren ISD,06908,Bert Goens Learning Center,87,13,54,154
80000,Van Buren ISD,09764,Behavioral Education Center,31,4,15,50
80000,Van Buren ISD,09768,Community-based Transition Center,29,5,19,53
80010,South Haven Public Schools,02216,Lincoln School,196,20,85,301
80010,South Haven Public Schools,02345,Maple Grove Elementary School,226,25,136,387
80010,South Haven Public Schools,03515,South Haven High School,281,48,401,730
80010,South Haven Public Schools,07769,Baseline Middle School,283,37,239,559
80010,South Haven Public Schools,09522,North Shore Elementary,172,19,122,313
80020,Bangor Public Schools,00189,Bangor High School,224,19,196,439
80020,Bangor Public Schools,04961,Bangor Middle School,173,17,101,291
80020,Bangor Public Schools,06949,Bangor Primary School,167,15,90,272
80020,Bangor Public Schools,08412,South Walnut Elementary School,197,18,79,294
80040,Covert Public Schools,00816,Covert Elementary School,302,9,16,327
80040,Covert Public Schools,00817,Covert High School,220,14,28,262
80040,Covert Public Schools,07237,Covert Middle School,131,7,16,154
80050,Decatur Public Schools,00888,Decatur High School,151,47,126,324
80050,Decatur Public Schools,05055,Davis Elementary School,196,44,136,376
80050,Decatur Public Schools,05056,Decatur Middle School,173,32,102,307
80090,Bloomingdale Public School District,00357,Bloomingdale High School,241,38,143,422
80090,Bloomingdale Public School District,00358,Bloomingdale Elementary School,269,37,105,411
80090,Bloomingdale Public School District,05037,Pullman Elementary School,282,9,21,312
80090,Bloomingdale Public School District,09367,Bloomingdale Middle School,191,24,61,276
80110,Gobles Public School District,01429,Gobles Elementary School,217,53,241,511
80110,Gobles Public School District,01430,Gobles High School,146,40,270,456
80120,Hartford Public School District,00085,Southwest Michigan Community School,111,4,37,152
80120,Hartford Public School District,01598,Hartford High School,226,45,155,426
80120,Hartford Public School District,01599,Woodside Elementary School,216,23,54,293
80120,Hartford Public School District,02721,Red Arrow Elementary School,254,33,54,341
80120,Hartford Public School District,06343,Hartford Middle School,203,26,73,302
80130,Lawrence Public School District,02139,Lawrence Elementary School,219,30,150,399
80130,Lawrence Public School District,02140,Lawrence Jr/Sr High School,159,26,163,348
80140,Lawton Community School District,02141,Lawton Elementary School,251,54,181,486
80140,Lawton Community School District,02142,Lawton High School,144,30,157,331
80140,Lawton Community School District,06370,Lawton Middle School,120,28,103,251
80140,Lawton Community School District,09635,Alternative and Adult Education,16,4,7,27
80150,Mattawan Consolidated School,02438,Mattawan Early Elem. School,120,26,710,856
80150,Mattawan Consolidated School,02439,Mattawan High School,103,35,1016,1154
80150,Mattawan Consolidated School,05678,Mattawan Middle School,118,53,763,934
80150,Mattawan Consolidated School,07495,Mattawan Later Elem. School,121,43,728,892
80160,Paw Paw Public School District,00341,Paw Paw Early Elementary School,167,35,255,457
80160,Paw Paw Public School District,02541,Paw Paw Middle School,177,38,293,508
80160,Paw Paw Public School District,02980,Paw Paw High School,180,51,471,702
80160,Paw Paw Public School District,07750,Michigan Avenue Academy,115,14,81,210
80160,Paw Paw Public School District,09043,Paw Paw Later Elementary,170,43,275,488
80160,Paw Paw Public School District,09303,Cedar Street Community and Family Center,13,3,12,28
80240,Bangor Township S/D #8,05559,Wood School - Bangor Twp #8,3,0,18,21
81000,Washtenaw ISD,04391,Washtenaw County Youth Center - Educational Programs,8,0,18,26
81000,Washtenaw ISD,06147,High Point School,155,4,28,187
81000,Washtenaw ISD,07487,Young Adult Programs,33,0,76,109
81000,Washtenaw ISD,09239,Local-Based SpecEd Programs,7,0,38,45
81010,Ann Arbor Public Schools,00006,Abbot School,86,11,200,297
81010,Ann Arbor Public Schools,00099,Angell School,28,11,271,310
81010,Ann Arbor Public Schools,00163,Ann Arbor Open at Mack School,43,7,437,487
81010,Ann Arbor Public Schools,00455,Burns Park Elementary School,58,10,355,423
81010,Ann Arbor Public Schools,00533,Carpenter School,117,15,201,333
81010,Ann Arbor Public Schools,00915,Dicken Elementary School,87,8,284,379
81010,Ann Arbor Public Schools,01064,Eberwhite School,46,6,283,335
81010,Ann Arbor Public Schools,01271,Forsythe Middle School,106,12,545,663
81010,Ann Arbor Public Schools,01534,Haisley Elementary School,89,11,317,417
81010,Ann Arbor Public Schools,01939,John Allen School,103,31,251,385
81010,Ann Arbor Public Schools,02143,Uriah H. Lawton School,58,9,401,468
81010,Ann Arbor Public Schools,02303,Bach Elementary School,56,9,283,348
81010,Ann Arbor Public Schools,02582,Mary D. Mitchell School,131,34,114,279
81010,Ann Arbor Public Schools,02766,Northside Elementary School,82,28,169,279
81010,Ann Arbor Public Schools,02973,Pattengill School,98,20,195,313
81010,Ann Arbor Public Schools,03060,Pittsfield School,106,9,114,229
81010,Ann Arbor Public Schools,03488,Slauson Middle School,110,28,581,719
81010,Ann Arbor Public Schools,04131,Tappan Middle School,124,23,575,722
81010,Ann Arbor Public Schools,04182,Thurston Elementary School,38,17,378,433
81010,Ann Arbor Public Schools,04562,Wines Elementary School,21,1,361,383
81010,Ann Arbor Public Schools,04882,Pioneer High School,298,53,1922,2273
81010,Ann Arbor Public Schools,05641,Scarlett Middle School,225,41,275,541
81010,Ann Arbor Public Schools,05671,Huron High School,302,62,1422,1786
81010,Ann Arbor Public Schools,05745,Community High School,28,5,448,481
81010,Ann Arbor Public Schools,05760,Martin Luther King Elem. School,28,3,384,415
81010,Ann Arbor Public Schools,06304,Clague Middle School,80,18,631,729
81010,Ann Arbor Public Schools,06336,Clifford E. Bryant Comm. School,93,13,209,315
81010,Ann Arbor Public Schools,06542,Roberto Clemente Center,53,4,24,81
81010,Ann Arbor Public Schools,06697,Logan Elementary School,62,7,277,346
81010,Ann Arbor Public Schools,08589,Ann Arbor Preschool and Family Center,97,10,0,107
81010,Ann Arbor Public Schools,08680,Stone High School,90,3,46,139
81010,Ann Arbor Public Schools,08895,Lakewood Elementary School,46,9,253,308
81010,Ann Arbor Public Schools,09840,Skyline High School,159,0,709,868
81020,School District of Ypsilanti,00052,Early College Alliance,12,0,70,82
81020,School District of Ypsilanti,00988,Chapelle Community School,246,17,33,296
81020,School District of Ypsilanti,01019,East Middle School,236,37,99,372
81020,School District of Ypsilanti,01153,Erickson School,257,28,138,423
81020,School District of Ypsilanti,01157,Estabrook School,240,40,170,450
81020,School District of Ypsilanti,02062,Perry Child Development Center,158,26,108,292
81020,School District of Ypsilanti,02825,Olive M. Adams Elementary School,185,10,33,228
81020,School District of Ypsilanti,04455,West Middle School,280,28,136,444
81020,School District of Ypsilanti,06273,Ypsilanti High School,673,97,389,1159
81020,School District of Ypsilanti,07871,Forest School,19,0,14,33
81020,School District of Ypsilanti,09923,Washtenaw County Drop Back In Academy,54,1,57,112
81040,Chelsea School District,00656,Chelsea High School,58,19,850,927
81040,Chelsea School District,00657,Beach Middle School,33,13,334,380
81040,Chelsea School District,02720,North Creek Elementary School,46,16,434,496
81040,Chelsea School District,03507,South Meadows Elementary School,32,19,332,383
81040,Chelsea School District,08517,Pierce Lake Elementary School,38,9,332,379
81040,Chelsea School District,09317,Cassidy Lake Technical School,5,0,35,40
81050,Dexter Community School District,00214,Wylie Elementary School,35,17,460,512
81050,Dexter Community School District,00913,Dexter High School,71,19,1122,1212
81050,Dexter Community School District,04609,Creekside Intermediate School,33,19,490,542
81050,Dexter Community School District,08039,Mill Creek Middle School,37,10,541,588
81050,Dexter Community School District,08040,Cornerstone Elementary School,23,12,392,427
81050,Dexter Community School District,08989,Bates Elementary School,30,4,324,358
81070,Lincoln Consolidated School District,00052,Early College Alliance,7,0,100,107
81070,Lincoln Consolidated School District,00308,Bessie Hoffman Elementary School,69,13,215,297
81070,Lincoln Consolidated School District,02186,Lincoln Brick Elementary School,313,52,278,643
81070,Lincoln Consolidated School District,02187,Lincoln Senior High School,474,125,862,1461
81070,Lincoln Consolidated School District,05166,Lincoln Middle School,412,88,639,1139
81070,Lincoln Consolidated School District,05235,Lincoln Model Elementary School,131,23,148,302
81070,Lincoln Consolidated School District,07190,Lincoln Redner Elementary School,203,53,219,475
81070,Lincoln Consolidated School District,09148,Child's Elementary,87,28,290,405
81080,Manchester Community Schools,02334,Manchester Middle School,63,9,313,385
81080,Manchester Community Schools,02335,Manchester High School,60,7,342,409
81080,Manchester Community Schools,05816,Luther C. Klager Elem. School,88,24,326,438
81100,Milan Area Schools,00052,Early College Alliance,5,0,44,49
81100,Milan Area Schools,02558,Milan High School,180,45,769,994
81100,Milan Area Schools,02930,Paddock Elementary School,128,20,344,492
81100,Milan Area Schools,05691,Milan Middle School,140,38,431,609
81100,Milan Area Schools,09182,Clayton H. Symons Elementary School,128,31,367,526
81120,Saline Area Schools,01768,Houghton Elementary School,35,1,346,382
81120,Saline Area Schools,03385,Saline Middle School,45,12,792,849
81120,Saline Area Schools,06203,Saline High School,103,29,1743,1875
81120,Saline Area Schools,07527,Pleasant Ridge Elementary School,52,12,411,475
81120,Saline Area Schools,08504,Woodland Meadows Elementary School,46,9,437,492
81120,Saline Area Schools,08505,Heritage School,43,14,735,792
81120,Saline Area Schools,09038,Harvest Elementary School,31,9,474,514
81120,Saline Area Schools,09897,Saline Alternative High School,11,3,49,63
81140,Whitmore Lake Public Schools,00052,Early College Alliance,2,0,21,23
81140,Whitmore Lake Public Schools,04515,Whitmore Lake High School,95,32,271,398
81140,Whitmore Lake Public Schools,07578,Whitmore Lake Elementary School,148,30,277,455
81140,Whitmore Lake Public Schools,07579,Whitmore Lake Middle School,99,24,204,327
81150,Willow Run Community Schools,01632,Ford Elementary School,208,25,47,280
81150,Willow Run Community Schools,01638,Kaiser Elementary School,232,12,47,291
81150,Willow Run Community Schools,01705,Holmes Elementary School,236,10,47,293
81150,Willow Run Community Schools,04550,Willow Run High School,311,27,109,447
81150,Willow Run Community Schools,05953,Cheney Academy,290,8,33,331
81150,Willow Run Community Schools,09404,Willow Run Middle School,166,17,36,219
81901,Honey Creek Community School,08241,Honey Creek Community School,23,6,191,220
81902,Central Academy,08333,Central Academy,389,37,88,514
81903,Washtenaw Technical Middle College,08483,Washtenaw Technical Middle College,42,0,340,382
81904,Ann Arbor Learning Community,08655,Ann Arbor Learning Community,34,1,229,264
81905,South Arbor Charter Academy,08741,South Arbor Charter Academy,97,51,619,767
81906,Fortis Academy,09447,Fortis Academy,272,74,391,737
81907,Victory Academy Charter School,09697,Victory Academy Charter School,140,6,3,149
81908,Eastern Washtenaw Multicultural Academy,09446,Eastern Washtenaw Multicultural Academy,146,15,93,254
82000,State of Michigan,00000,RESA/ISD students attending LEA school--82000,8,0,22,30
82010,Detroit City School District,00004,Henderson Academy,660,14,63,737
82010,Detroit City School District,00005,"Holmes, A.L.  Elementary School",442,6,58,506
82010,Detroit City School District,00009,"Holmes, O.W. Elementary-Middle School",559,8,68,635
82010,Detroit City School District,00015,Robinson Elementary-Middle School,474,11,71,556
82010,Detroit City School District,00018,Medicine and Community Health Academy at Cody,91,2,15,108
82010,Detroit City School District,00019,Academy of Critical Thinkers at Cody,90,1,13,104
82010,Detroit City School District,00022,Detroit Institute of Technology at Cody,72,0,5,77
82010,Detroit City School District,00026,Cody Academy of Public Leadership,78,2,18,98
82010,Detroit City School District,00029,Davis Aerospace High School,149,17,40,206
82010,Detroit City School District,00030,Osborn College Preparatory Academy,102,0,17,119
82010,Detroit City School District,00032,Osborn Academy of Mathematics,102,1,10,113
82010,Detroit City School District,00035,Osborn Evergreen Academy of Design and Alternative Energy,76,5,23,104
82010,Detroit City School District,00038,Detroit City High School,429,6,159,594
82010,Detroit City School District,00039,Detroit International Academy for Young Women,385,26,142,553
82010,Detroit City School District,00082,Earhart Middle School,516,11,48,575
82010,Detroit City School District,00103,Ann Arbor Trail Magnet Middle School,319,27,121,467
82010,Detroit City School District,00168,Bagley Elementary School,360,21,92,473
82010,Detroit City School District,00176,Golightly Education Center,375,40,229,644
82010,Detroit City School District,00213,Barton Elementary School,223,4,48,275
82010,Detroit City School District,00238,"Clemente, Roberto Academy",734,10,52,796
82010,Detroit City School District,00277,Bennett Elementary School,507,8,19,534
82010,Detroit City School District,00446,Bunche Elementary School,232,7,18,257
82010,Detroit City School District,00456,Burns Elementary School,641,9,21,671
82010,Detroit City School District,00463,Burt Elementary School,226,5,19,250
82010,Detroit City School District,00468,Burton International School,324,30,281,635
82010,Detroit City School District,00510,Campbell Elementary School,196,4,7,207
82010,Detroit City School District,00542,Carstens Elementary School,206,5,32,243
82010,Detroit City School District,00546,Carver Elementary School,388,9,104,501
82010,Detroit City School District,00554,Cass Technical High School,915,111,1169,2195
82010,Detroit City School District,00617,Central High School,718,17,179,914
82010,Detroit City School District,00689,Chrysler Elementary School,61,20,96,177
82010,Detroit City School District,00739,Cody College Preparatory Upper School of Teaching and Learning,609,17,263,889
82010,Detroit City School District,00741,Coffey Elementary/Middle School,355,8,48,411
82010,Detroit City School District,00781,Cooke Elementary School,235,12,97,344
82010,Detroit City School District,00785,Cooley High School,840,21,333,1194
82010,Detroit City School District,00826,Crary Elementary School,255,10,44,309
82010,Detroit City School District,00857,"Marshall, Thurgood Elementary School",322,11,32,365
82010,Detroit City School District,00880,Davison Elementary School,656,14,44,714
82010,Detroit City School District,00902,Denby High School,829,18,325,1172
82010,Detroit City School District,00908,Detroit Day School For The Deaf,211,0,216,427
82010,Detroit City School District,00925,Dixon Elementary School,498,11,77,586
82010,Detroit City School District,00939,Dossin Elementary School,295,6,43,344
82010,Detroit City School District,00966,Duffield Elementary School,299,17,50,366
82010,Detroit City School District,00975,Durfee Elementary School,609,3,185,797
82010,Detroit City School District,01043,King High School,895,48,433,1376
82010,Detroit City School District,01084,Edison Elementary School,270,16,54,340
82010,Detroit City School District,01087,Edmonson Elementary School,202,6,34,242
82010,Detroit City School District,01134,Emerson Elementary School,255,6,23,284
82010,Detroit City School District,01211,Farwell Middle School,408,6,46,460
82010,Detroit City School District,01236,Finney High School,452,6,189,647
82010,Detroit City School District,01244,Fitzgerald Elementary School,485,11,80,576
82010,Detroit City School District,01248,Fleming Elementary School,676,3,79,758
82010,Detroit City School District,01362,Gardner Elementary School,220,4,8,232
82010,Detroit City School District,01438,Gompers Elementary School,249,11,48,308
82010,Detroit City School District,01493,Greenfield Union Elementary School,381,8,130,519
82010,Detroit City School District,01518,Bethune Academy,522,8,99,629
82010,Detroit City School District,01552,Barbara Jordan Elementary,436,19,120,575
82010,Detroit City School District,01562,Hanstein Elementary School,219,8,46,273
82010,Detroit City School District,01569,Harding Elementary School,251,4,18,273
82010,Detroit City School District,01574,Harms Elementary School,589,6,26,621
82010,Detroit City School District,01634,Ford High School,965,20,222,1207
82010,Detroit City School District,01690,Holcomb Elementary School,238,3,21,262
82010,Detroit City School District,01774,Howe Elementary School,374,6,70,450
82010,Detroit City School District,01802,Hutchins Elementary School,410,6,77,493
82010,Detroit City School District,01803,Hutchinson Elementary School,358,3,33,394
82010,Detroit City School District,01887,Jamieson Elementary School,395,5,52,452
82010,Detroit City School District,02030,Kettering High School,668,19,258,945
82010,Detroit City School District,02036,"King, John R. Academic and Performing Arts Academy",734,21,112,867
82010,Detroit City School District,02058,Blackwell Institute,587,13,112,712
82010,Detroit City School District,02167,Lessenger Elementary-Middle School,348,9,59,416
82010,Detroit City School District,02245,Logan Elementary School,431,16,140,587
82010,Detroit City School District,02301,MacDowell Elementary School,302,16,82,400
82010,Detroit City School District,02341,Mann Elementary School,341,13,33,387
82010,Detroit City School District,02377,Law Elementary School,754,11,116,881
82010,Detroit City School District,02383,Mark Twain Elementary School,291,9,35,335
82010,Detroit City School District,02390,Marquette Elementary School,681,23,130,834
82010,Detroit City School District,02431,Mason Elementary School,331,11,28,370
82010,Detroit City School District,02448,Maybury Elementary School,592,7,16,615
82010,Detroit City School District,02458,McColl Elementary School,221,11,23,255
82010,Detroit City School District,02465,Randolph Career and Technical Center,1,0,1,2
82010,Detroit City School District,02475,McKenny Elementary School,249,8,35,292
82010,Detroit City School District,02479,Golightly Career and Technical  Center,0,0,1,1
82010,Detroit City School District,02644,Mumford High School,1158,40,764,1962
82010,Detroit City School District,02648,Murphy Elementary-Middle School,451,9,112,572
82010,Detroit City School District,02669,Neinas Elementary School,360,2,17,379
82010,Detroit City School District,02701,Rutherford Elementary School,347,14,57,418
82010,Detroit City School District,02703,Nichols Elementary School,367,18,43,428
82010,Detroit City School District,02708,Nolan Elementary School,761,15,49,825
82010,Detroit City School District,02778,Northwestern High School,998,24,369,1391
82010,Detroit City School District,02811,Oakman Elementary / Orthopedic School,166,1,75,242
82010,Detroit City School District,02855,Osborn Upper School of Global Communications and Culture,635,8,257,900
82010,Detroit City School District,02882,Bates Academy,244,55,556,855
82010,Detroit City School District,02921,Owen Academy,259,3,30,292
82010,Detroit City School District,02951,Parker Elementary School,406,6,110,522
82010,Detroit City School District,02969,Pasteur Elementary School,276,10,74,360
82010,Detroit City School District,03015,Pershing High School,872,7,298,1177
82010,Detroit City School District,03123,Priest Elementary School,646,22,73,741
82010,Detroit City School District,03130,Pulaski Elementary School,586,8,59,653
82010,Detroit City School District,03420,Schulze Elementary School,517,31,156,704
82010,Detroit City School District,03466,Sherrill Elementary School,426,5,121,552
82010,Detroit City School District,03540,Southeastern High School,1665,42,526,2233
82010,Detroit City School District,03555,Southwestern High School,776,19,201,996
82010,Detroit City School District,03558,Spain Elementary School,604,29,198,831
82010,Detroit City School District,03703,Ludington Magnet Middle School,321,47,280,648
82010,Detroit City School District,03717,"Young, Coleman A. Elementary",476,15,108,599
82010,Detroit City School District,03725,Loving Elementary School,287,9,5,301
82010,Detroit City School District,03737,Edward (Duke) Ellington Conservatory of Music/Art,478,12,114,604
82010,Detroit City School District,04062,"Brown, Ronald Academy",898,23,203,1124
82010,Detroit City School District,04129,Taft Middle School,303,8,63,374
82010,Detroit City School District,04156,Thirkell Elementary School,382,7,25,414
82010,Detroit City School District,04222,Trix Elementary School,467,5,110,582
82010,Detroit City School District,04292,Vernor Elementary School,247,5,74,326
82010,Detroit City School District,04319,Bow Elementary School,308,2,143,453
82010,Detroit City School District,04365,"Detroit Transition Center, East",262,6,4,272
82010,Detroit City School District,04406,Wayne Elementary School,371,8,56,435
82010,Detroit City School District,04413,Sampson Academy,463,3,40,506
82010,Detroit City School District,04420,Webster Elementary School,279,7,28,314
82010,Detroit City School District,04477,Western International High School,1239,52,437,1728
82010,Detroit City School District,04500,White Elementary School,710,7,64,781
82010,Detroit City School District,04527,Wilkins Elementary School,311,1,77,389
82010,Detroit City School District,04554,Phoenix Elementary,522,6,8,536
82010,Detroit City School District,04807,Van Zile Elementary School,411,7,17,435
82010,Detroit City School District,04812,McFarlane Elementary School,263,9,34,306
82010,Detroit City School District,05445,Hally Magnet Middle School,223,24,129,376
82010,Detroit City School District,05553,Carleton Elementary School,402,13,35,450
82010,Detroit City School District,05675,Glazer Elementary School,246,3,33,282
82010,Detroit City School District,05773,Drew Middle School,350,5,75,430
82010,Detroit City School District,06074,Stewart Elementary School,626,4,47,677
82010,Detroit City School District,06103,Noble Elementary School,427,9,92,528
82010,Detroit City School District,06342,Boykin Continuing Ed. Center,59,0,15,74
82010,Detroit City School District,06381,Detroit Transition Center West,150,12,22,184
82010,Detroit City School District,06631,"Beckham, William Academy",560,1,129,690
82010,Detroit City School District,06693,Vetal Elementary School,376,8,111,495
82010,Detroit City School District,06971,Renaissance High School,265,47,726,1038
82010,Detroit City School District,07024,Crockett High School,540,32,309,881
82010,Detroit City School District,07097,Ferguson Academy for Young Women,236,5,48,289
82010,Detroit City School District,07135,Douglass Academy for Young Men,272,9,31,312
82010,Detroit City School District,07326,Foreign Language Immersion,225,40,370,635
82010,Detroit City School District,07500,Clippert Academy,391,7,49,447
82010,Detroit City School District,07581,Garvey Academy,580,4,77,661
82010,Detroit City School District,07632,Malcolm X Academy,227,9,70,306
82010,Detroit City School District,07633,Robeson Academy,356,13,166,535
82010,Detroit City School District,07651,Trombly Alternative High School,293,5,73,371
82010,Detroit City School District,07654,Communication and Media Arts HS,202,22,253,477
82010,Detroit City School District,07793,Academy of The Americas,526,44,89,659
82010,Detroit City School District,07794,Detroit School of Arts,368,47,309,724
82010,Detroit City School District,07795,Jemison School of Choice,382,5,86,473
82010,Detroit City School District,07880,Barsamian Preparatory Center,42,0,9,51
82010,Detroit City School District,08004,Westside Multicultural Academy,246,3,31,280
82010,Detroit City School District,08396,"Hughes, Langston Academy",227,4,68,299
82010,Detroit City School District,08526,Crosman Alternative High School,211,6,47,264
82010,Detroit City School District,08925,Detroit Lions Alternative Education,121,0,10,131
82010,Detroit City School District,08928,"McKinney, Johnson H. Day Treatment Center",63,2,16,81
82010,Detroit City School District,08929,West Side Academy Alt. Ed,563,31,49,643
82010,Detroit City School District,08951,"Field, Moses",129,4,29,162
82010,Detroit City School District,08987,Beard Elementary Early Childhood Center,65,0,4,69
82010,Detroit City School District,09121,Fisher Magnet Lower Academy,774,19,73,866
82010,Detroit City School District,09125,"Wright, Charles School",488,13,196,697
82010,Detroit City School District,09341,"Scott, Brenda Middle School",423,13,59,495
82010,Detroit City School District,09342,Hancock,33,0,10,43
82010,Detroit City School District,09345,Fisher Magnet Upper Academy,732,21,169,922
82010,Detroit City School District,09467,Detroit High School for Technology,86,3,75,164
82010,Detroit City School District,09474,Cooley North Wing,95,5,28,128
82010,Detroit City School District,09475,Kettering West Wing,206,8,22,236
82010,Detroit City School District,09592,Jerry L White Center High School,212,15,49,276
82010,Detroit City School District,09594,Keidan Special Education School,136,3,51,190
82010,Detroit City School District,09659,Detroit Association Black Orgs (DABO),157,0,72,229
82010,Detroit City School District,09661,Riverside Preparatory Middle College Academy,76,3,22,101
82010,Detroit City School District,09716,Detroit Behavioral Institute,47,0,16,63
82010,Detroit City School District,09788,Turning Point Academy,34,1,5,40
82010,Detroit City School District,09991,Brewer Elementary School,608,5,124,737
82010,Detroit City School District,09992,Clark Elementary School,552,6,92,650
82010,Detroit City School District,09994,Hamilton Elementary-Middle School,523,3,108,634
82020,Allen Park Public Schools,00065,Allen Park High School,204,92,912,1208
82020,Allen Park Public Schools,00121,Arno Elementary School,135,32,325,492
82020,Allen Park Public Schools,00279,Bennie Elementary School,98,40,290,428
82020,Allen Park Public Schools,02229,Lindemann Elementary School,101,35,438,574
82020,Allen Park Public Schools,03517,Allen Park Middle School,231,83,598,912
82020,Allen Park Public Schools,08422,Allen Park Community School,90,12,53,155
82030,Dearborn City School District,00086,Dearborn Magnet High School,13,1,25,39
82030,Dearborn City School District,00432,Bryant Middle School,157,29,503,689
82030,Dearborn City School District,00639,Charles A. Lindbergh Elementary School,60,17,275,352
82030,Dearborn City School District,00886,Dearborn High School,585,49,1108,1742
82030,Dearborn City School District,00954,Snow Elementary School,120,21,226,367
82030,Dearborn City School District,00977,Duvall Elementary School,62,8,199,269
82030,Dearborn City School District,01092,Edsel Ford High School,650,74,790,1514
82030,Dearborn City School District,01261,Fordson High School,1477,91,794,2362
82030,Dearborn City School District,01635,Henry Ford Elementary School,531,61,112,704
82030,Dearborn City School District,01637,Haigh Elementary School,134,11,305,450
82030,Dearborn City School District,01974,Howard Elementary School,70,22,270,362
82030,Dearborn City School District,02356,Maples Elementary School,482,31,73,586
82030,Dearborn City School District,02460,McDonald Elementary School,318,24,37,379
82030,Dearborn City School District,02567,Miller Elementary School,451,31,67,549
82030,Dearborn City School District,02793,Smith Middle School,182,36,391,609
82030,Dearborn City School District,02813,Oakman Elementary School,242,12,34,288
82030,Dearborn City School District,03206,River Oaks Elementary School,196,27,121,344
82030,Dearborn City School District,03383,Salina Intermediate 4 - 8,434,15,58,507
82030,Dearborn City School District,04088,Stout Middle School,398,46,196,640
82030,Dearborn City School District,04514,Whitmore-Bolles Elementary School,109,17,175,301
82030,Dearborn City School District,04536,William Ford Elementary School,490,44,95,629
82030,Dearborn City School District,04541,Nowlin Elementary School,69,8,113,190
82030,Dearborn City School District,04837,Lowrey Elementary School,538,39,120,697
82030,Dearborn City School District,05396,Long Elementary School,91,23,105,219
82030,Dearborn City School District,05847,Woodworth Middle School,551,45,154,750
82030,Dearborn City School District,05850,Lowrey Middle School,405,31,95,531
82030,Dearborn City School District,06384,Howe Trainable Center and Montessori,65,4,113,182
82030,Dearborn City School District,07818,Iris Becker Elementary School,227,10,37,274
82030,Dearborn City School District,09251,Salina Elementary P - 3,447,20,37,504
82030,Dearborn City School District,09400,McCollough Elementary School,332,20,83,435
82030,Dearborn City School District,09408,Unis Middle School,449,30,112,591
82030,Dearborn City School District,09529,Geer Park Elementary,233,21,78,332
82030,Dearborn City School District,09775,Henry Ford Early College,82,6,66,154
82040,Dearborn Heights School District #7,00249,Bedford School,152,27,109,288
82040,Dearborn Heights School District #7,02810,Oakley W. Best Middle School,359,99,237,695
82040,Dearborn Heights School District #7,02943,Pardee School,188,41,124,353
82040,Dearborn Heights School District #7,04950,Annapolis High School,339,108,384,831
82040,Dearborn Heights School District #7,05357,Polk Elementary School,207,33,116,356
82040,Dearborn Heights School District #7,08398,Madison Elementary School,133,28,153,314
82045,Melvindale-North Allen Park Schools,01979,Julian O. Strong Middle School,400,85,173,658
82045,Melvindale-North Allen Park Schools,02507,Melvindale High School,438,98,328,864
82045,Melvindale-North Allen Park Schools,07381,Rogers Early Elementary School,216,42,128,386
82045,Melvindale-North Allen Park Schools,09520,Allendale Elementary School,529,109,222,860
82050,Garden City School District,00944,Douglas School,182,44,236,462
82050,Garden City School District,01205,Farmington Elementary School,144,33,216,393
82050,Garden City School District,01359,Garden City High School,383,103,1011,1497
82050,Garden City School District,01642,Henry Ruff School,222,43,236,501
82050,Garden City School District,02136,Lathers School,186,51,201,438
82050,Garden City School District,02508,Memorial Elementary School,173,31,282,486
82050,Garden City School District,04463,Garden City Middle School,248,61,356,665
82050,Garden City School District,04674,Burger Development Center,128,28,201,357
82050,Garden City School District,07376,Cambridge High School,152,2,227,381
82055,Grosse Pointe Public Schools,00424,Brownell Middle School,19,3,626,648
82055,Grosse Pointe Public Schools,01226,Ferry Elementary School,17,2,365,384
82055,Grosse Pointe Public Schools,01386,George Defer Elementary School,53,6,357,416
82055,Grosse Pointe Public Schools,01512,Grosse Pointe South High School,101,10,1508,1619
82055,Grosse Pointe Public Schools,02026,Kerby Elementary School,7,6,351,364
82055,Grosse Pointe Public Schools,02172,Lewis Maire Elementary School,18,1,308,327
82055,Grosse Pointe Public Schools,02430,Stevens T. Mason Elementary School,47,14,225,286
82055,Grosse Pointe Public Schools,02597,John Monteith Elementary School,24,8,521,553
82055,Grosse Pointe Public Schools,02937,Parcells Middle School,92,21,597,710
82055,Grosse Pointe Public Schools,03007,Richard Elementary School,4,1,391,396
82055,Grosse Pointe Public Schools,03031,Pierce Middle School,60,9,543,612
82055,Grosse Pointe Public Schools,03237,Robert Trombly Elementary School,24,3,259,286
82055,Grosse Pointe Public Schools,05019,Charles A. Poupard Elem. School,132,16,197,345
82055,Grosse Pointe Public Schools,05142,Grosse Pointe North High School,153,32,1237,1422
82060,Hamtramck Public Schools,00916,Dickinson West Elementary School,411,16,91,518
82060,Hamtramck Public Schools,01554,Hamtramck High School,701,33,227,961
82060,Hamtramck Public Schools,01689,Holbrook School,264,3,11,278
82060,Hamtramck Public Schools,02055,Kosciuszko School,333,20,50,403
82060,Hamtramck Public Schools,07474,Dickinson East Elementary School,558,28,62,648
82060,Hamtramck Public Schools,08897,Early Childhood Elementary School,186,12,21,219
82060,Hamtramck Public Schools,09948,Horizon Alternative Education,91,1,23,115
82070,Highland Park City Schools,01633,Ford Acad. for Comm/Perf Arts,295,1,129,425
82070,Highland Park City Schools,01666,Highland Park Community H.S.,598,9,215,822
82070,Highland Park City Schools,03228,Barber Focus Sch of Math Sci Tec,346,1,112,459
82070,Highland Park City Schools,08376,Career Academy/Adult Education,84,0,57,141
82080,School District of the City of Inkster,00545,Baylor Woodson Elementary School,476,27,71,574
82080,School District of the City of Inkster,01216,Blanchette Middle School,480,26,61,567
82080,School District of the City of Inkster,01840,Inkster High School,884,46,489,1419
82080,School District of the City of Inkster,02964,Meek-Milton Elementary School,437,18,60,515
82080,School District of the City of Inkster,09695,Inkster Alternative Education,120,3,82,205
82090,Lincoln Park Public Schools,00997,Earl F. Carr School,138,33,98,269
82090,Lincoln Park Public Schools,01293,Frank G. Mixter School,102,25,76,203
82090,Lincoln Park Public Schools,01752,Hoover School,141,21,108,270
82090,Lincoln Park Public Schools,01879,James Foote School,219,40,115,374
82090,Lincoln Park Public Schools,02025,Keppen School,199,37,64,300
82090,Lincoln Park Public Schools,02069,Lafayette School,388,40,93,521
82090,Lincoln Park Public Schools,02207,Lincoln Park High School,638,166,541,1345
82090,Lincoln Park Public Schools,02442,Max Paun School,183,37,82,302
82090,Lincoln Park Public Schools,03153,Raupp School,247,26,43,316
82090,Lincoln Park Public Schools,08187,Crowley School,5,1,19,25
82090,Lincoln Park Public Schools,08692,Lincoln Park Middle School,390,73,207,670
82090,Lincoln Park Public Schools,08832,LeBlanc School,23,0,9,32
82095,Livonia Public Schools,00025,Stevenson High School,147,60,1905,2112
82095,Livonia Public Schools,00716,Cleveland Elementary School,145,22,269,436
82095,Livonia Public Schools,00788,Coolidge Elementary School,81,18,388,487
82095,Livonia Public Schools,00791,Cooper Upper Elementary School,180,74,465,719
82095,Livonia Public Schools,01137,Emerson Middle School,215,71,566,852
82095,Livonia Public Schools,01302,Franklin High School,425,130,1350,1905
82095,Livonia Public Schools,01372,Garfield Elementary School,161,9,193,363
82095,Livonia Public Schools,01471,Grant Elementary School,96,28,335,459
82095,Livonia Public Schools,01613,Hayes Elementary School,78,38,266,382
82095,Livonia Public Schools,01706,Holmes Middle School,74,29,756,859
82095,Livonia Public Schools,01750,Hoover Elementary School,33,17,500,550
82095,Livonia Public Schools,01873,Jackson Center,5,0,106,111
82095,Livonia Public Schools,01947,Kennedy Elementary School,43,8,336,387
82095,Livonia Public Schools,01967,Johnson Upper Elementary School,146,29,470,645
82095,Livonia Public Schools,02171,Cass Elementary School,42,10,258,310
82095,Livonia Public Schools,02501,N.W. Wayne Skill Center,103,5,185,293
82095,Livonia Public Schools,03148,Randolph Elementary School,36,12,313,361
82095,Livonia Public Schools,03203,Riley Upper Elementary School,99,34,675,808
82095,Livonia Public Schools,03229,Frost Middle School,141,43,644,828
82095,Livonia Public Schools,03277,Roosevelt Elementary School,50,23,318,391
82095,Livonia Public Schools,04848,Churchill High School,299,97,1632,2028
82095,Livonia Public Schools,04907,N.W. Wayne Trainable Center,36,3,45,84
82095,Livonia Public Schools,04992,Buchanan Elementary School,60,14,369,443
82095,Livonia Public Schools,05063,Dickinson Center,8,0,26,34
82095,Livonia Public Schools,07377,Webster Elementary School,9,3,230,242
82095,Livonia Public Schools,08585,Perrinville Early Childhood Center,23,0,147,170
82095,Livonia Public Schools,09673,Rosedale Elementary,69,6,246,321
82100,Plymouth-Canton Community Schools,00064,Allen Elementary School,65,26,359,450
82100,Plymouth-Canton Community Schools,00330,Bird Elementary School,24,7,591,622
82100,Plymouth-Canton Community Schools,01207,Farrand Elementary School,118,27,292,437
82100,Plymouth-Canton Community Schools,01356,Gallimore Elementary School,81,16,369,466
82100,Plymouth-Canton Community Schools,02269,Discovery Middle School,98,24,860,982
82100,Plymouth-Canton Community Schools,03078,West Middle School,61,24,762,847
82100,Plymouth-Canton Community Schools,03079,East Middle School,100,37,613,750
82100,Plymouth-Canton Community Schools,03082,Central Middle School,171,82,595,848
82100,Plymouth-Canton Community Schools,03492,Smith Elementary School,23,9,506,538
82100,Plymouth-Canton Community Schools,04055,Starkweather CEC,49,6,151,206
82100,Plymouth-Canton Community Schools,04849,Pioneer Middle School,84,27,753,864
82100,Plymouth-Canton Community Schools,04905,Isbister Elementary School,27,9,498,534
82100,Plymouth-Canton Community Schools,05084,Fiegel Elementary School,104,16,295,415
82100,Plymouth-Canton Community Schools,05503,Tanger Center,13,1,123,137
82100,Plymouth-Canton Community Schools,05770,Salem High School,246,52,1755,2053
82100,Plymouth-Canton Community Schools,06274,Miller Elementary School,56,23,401,480
82100,Plymouth-Canton Community Schools,06276,Canton High School,235,62,1755,2052
82100,Plymouth-Canton Community Schools,06675,Eriksson Elementary School,112,24,440,576
82100,Plymouth-Canton Community Schools,06676,Field Elementary School,96,28,441,565
82100,Plymouth-Canton Community Schools,06677,Hulsing Elementary School,66,9,301,376
82100,Plymouth-Canton Community Schools,07250,Hoben Elementary School,68,15,384,467
82100,Plymouth-Canton Community Schools,07989,Bentley Elementary School,54,18,500,572
82100,Plymouth-Canton Community Schools,07990,Tonda Elementary School,52,11,462,525
82100,Plymouth-Canton Community Schools,08899,Dodson Elementary School,39,2,460,501
82100,Plymouth-Canton Community Schools,08997,Plymouth High School,232,56,1817,2105
82100,Plymouth-Canton Community Schools,09646,Workman Elementary School,30,4,723,757
82110,Redford Union School District,00445,Bulman School,215,36,155,406
82110,Redford Union School District,02296,MacGowan School,185,41,141,367
82110,Redford Union School District,03167,Redford Union High School,484,90,530,1104
82110,Redford Union School District,04094,Stuckey Elementary School,224,35,129,388
82110,Redford Union School District,05162,Hilbert Middle School,353,60,287,700
82110,Redford Union School District,06642,Kaselemis Center,34,4,105,143
82110,Redford Union School District,07309,Pearson Education Center,68,6,30,104
82110,Redford Union School District,08278,Elem. Day Treatment,69,7,29,105
82120,River Rouge School District,00105,Ann Visger K-5 Preparatory Academy,328,7,47,382
82120,River Rouge School District,03208,River Rouge Middle College High School Academy,408,21,57,486
82120,River Rouge School District,09968,CB Sabbath K-8 Preparatory Academy,382,18,30,430
82130,Romulus Community Schools,00807,Cory Elementary School,154,16,45,215
82130,Romulus Community Schools,03260,Romulus Senior High School,598,135,436,1169
82130,Romulus Community Schools,06051,Merriman Elementary School,213,12,36,261
82130,Romulus Community Schools,06590,Wick Elementary School,185,42,80,307
82130,Romulus Community Schools,06678,Romulus Middle School,310,77,161,548
82130,Romulus Community Schools,06679,Barth Elementary School,216,39,203,458
82130,Romulus Community Schools,06680,Hale Creek Elementary School,180,31,82,293
82130,Romulus Community Schools,08898,Romulus Elementary School,274,41,86,401
82130,Romulus Community Schools,09025,Community Middle/Community High School,119,7,63,189
82130,Romulus Community Schools,09295,Romulus Adult Education Alternative,17,0,24,41
82140,South Redford School District,00124,Vandenberg Elementary School,177,43,128,348
82140,South Redford School District,01239,Fisher Elementary School,209,34,214,457
82140,South Redford School District,01888,Jane Addams Elementary School,121,26,166,313
82140,South Redford School District,01941,John D. Pierce Middle School,327,87,365,779
82140,South Redford School District,02149,Lee M. Thurston High School,451,99,619,1169
82140,South Redford School District,04167,Thomas Jefferson Elem. School,105,26,224,355
82140,South Redford School District,09162,Shear Early Childhood Center,4,1,0,5
82150,Taylor School District,00345,Blair Moody Elementary School,230,41,79,350
82150,Taylor School District,00642,Sixth Grade Academy,343,63,199,605
82150,Taylor School District,00698,Clarence Randall Elem. School,259,53,227,539
82150,Taylor School District,01159,Eureka Heights Elementary School,190,33,84,307
82150,Taylor School District,01237,Fischer Elementary School,170,24,57,251
82150,Taylor School District,01249,Titan Alternative High School,59,11,35,105
82150,Taylor School District,01695,Holland Elementary School,158,44,125,327
82150,Taylor School District,01944,John F. Kennedy High School,544,139,545,1228
82150,Taylor School District,02049,Kinyon Elementary School,257,33,160,450
82150,Taylor School District,03233,Robert J. West Middle School,377,95,283,755
82150,Taylor School District,03942,Hoover Middle School,360,76,166,602
82150,Taylor School District,04141,Taylor Parks Elementary School,319,60,115,494
82150,Taylor School District,06275,Bernice McDowell Elem. School,240,33,94,367
82150,Taylor School District,06403,Myers Elementary School,343,11,27,381
82150,Taylor School District,06428,Truman High School,762,147,672,1581
82150,Taylor School District,06907,Taylor Career and Technical Center,1,0,0,1
82155,Trenton Public Schools,01927,Jesse L. Anderson Elementary School,92,8,421,521
82155,Trenton Public Schools,03189,Richard C. Hedke Elem. School,60,27,268,355
82155,Trenton Public Schools,04138,William C. Taylor Elementary School,151,13,168,332
82155,Trenton Public Schools,04203,Trenton High School,132,30,824,986
82155,Trenton Public Schools,06130,Boyd W. Arthurs Middle School,126,24,530,680
82160,Wayne-Westland Community School District,00017,Adams Middle School,403,47,174,624
82160,Wayne-Westland Community School District,00043,Albert Schweitzer Elementary School,167,41,155,363
82160,Wayne-Westland Community School District,00048,Alexander Hamilton Elementary School,110,27,164,301
82160,Wayne-Westland Community School District,00273,Benjamin Franklin Middle School,403,75,197,675
82160,Wayne-Westland Community School District,00660,Tinkham Alternative Education,67,7,26,100
82160,Wayne-Westland Community School District,00874,David Hicks School,207,28,73,308
82160,Wayne-Westland Community School District,01111,Eugene B. Elliott Elem. School,212,32,67,311
82160,Wayne-Westland Community School District,01881,James Madison Elementary School,110,29,222,361
82160,Wayne-Westland Community School District,01894,Jefferson-Barns Elem. School,156,4,12,172
82160,Wayne-Westland Community School District,01950,John Glenn High School,784,205,1170,2159
82160,Wayne-Westland Community School District,01956,John Marshall Middle School,357,81,281,719
82160,Wayne-Westland Community School District,02029,Kettering Elementary School,156,43,163,362
82160,Wayne-Westland Community School District,02181,Lincoln Elementary School,255,14,19,288
82160,Wayne-Westland Community School District,02970,Patchin Elementary School,247,33,122,402
82160,Wayne-Westland Community School District,03262,Roosevelt/McGrath Elem. School,259,41,135,435
82160,Wayne-Westland Community School District,04130,Taft-Galloway Elementary School,215,25,89,329
82160,Wayne-Westland Community School District,04158,Thomas A. Edison Elem. School,153,24,189,366
82160,Wayne-Westland Community School District,04277,Vandenberg Elementary School,87,26,63,176
82160,Wayne-Westland Community School District,04334,Walker-Winter Elementary School,202,34,190,426
82160,Wayne-Westland Community School District,04407,Wayne Memorial High School,911,199,759,1869
82160,Wayne-Westland Community School District,04926,Adlai Stevenson Middle School,285,60,494,839
82160,Wayne-Westland Community School District,05295,Hoover Elementary School,155,41,64,260
82160,Wayne-Westland Community School District,05552,Wildwood Elementary School,169,44,238,451
82160,Wayne-Westland Community School District,05881,P.D. Graham Elementary School,130,33,293,456
82160,Wayne-Westland Community School District,07026,William Ford Career-Tech Center,13,1,37,51
82160,Wayne-Westland Community School District,09241,Wayne-Westland Adult and Community Education,57,6,105,168
82170,Wyandotte City School District,00008,Jo Brighton Skills Center,172,20,143,335
82170,Wyandotte City School District,01367,Garfield Elementary School,152,37,116,305
82170,Wyandotte City School District,01900,Jefferson Elementary School,132,33,175,340
82170,Wyandotte City School District,02591,Monroe Elementary School,181,30,224,435
82170,Wyandotte City School District,03267,Roosevelt High School,386,96,851,1333
82170,Wyandotte City School District,04128,Taft Elementary School,174,25,115,314
82170,Wyandotte City School District,04389,Washington Elementary School,130,33,207,370
82170,Wyandotte City School District,04587,Woodrow Wilson School,411,95,522,1028
82170,Wyandotte City School District,06726,Madison School,99,11,76,186
82170,Wyandotte City School District,08828,The Lincoln Center,132,23,65,220
82180,Flat Rock Community Schools,01169,Ethel C. Bobcean Elem. School,157,20,278,455
82180,Flat Rock Community Schools,01246,Flat Rock Community High School,171,66,342,579
82180,Flat Rock Community Schools,04172,Thomas Simpson Middle School,154,34,274,462
82180,Flat Rock Community Schools,05233,John M. Barnes Elem. School,158,34,246,438
82230,Crestwood School District,00042,Crestwood Accelerated Program,5,4,10,19
82230,Crestwood School District,00833,Crestwood High School,525,128,578,1231
82230,Crestwood School District,01669,Highview Elementary School,131,17,126,274
82230,Crestwood School District,01680,Hillcrest Elementary School,143,19,119,281
82230,Crestwood School District,02046,Kinloch Elementary School,230,61,205,496
82230,Crestwood School District,03216,Riverside Middle School,562,111,473,1146
82240,Westwood Community Schools,00867,Daly School,158,8,33,199
82240,Westwood Community Schools,03238,Robichaud Senior High School,458,31,136,625
82240,Westwood Community Schools,04177,Thorne Elementary School,554,45,103,702
82240,Westwood Community Schools,09536,Tomlinson Middle School,344,17,74,435
82240,Westwood Community Schools,09767,Westwood Alternative Education,28,0,45,73
82240,Westwood Community Schools,09935,Westwood Cyber High School,200,0,339,539
82250,Ecorse Public School District,01069,Ecorse Community High School,258,3,154,415
82250,Ecorse Public School District,03144,Ralph J. Bunche Academy,118,0,118,236
82250,Ecorse Public School District,03414,GrandPort Elementary Academy,165,0,143,308
82290,Gibraltar School District,00525,Oscar A. Carlson High School,226,53,804,1083
82290,Gibraltar School District,00637,Chapman Elementary School,106,24,340,470
82290,Gibraltar School District,00715,Parsons Elementary School,102,20,321,443
82290,Gibraltar School District,05417,Hunter Elementary School,109,25,297,431
82290,Gibraltar School District,06681,Shumate Middle School,225,58,612,895
82290,Gibraltar School District,06951,Frank E. Weiss Elem. School,98,15,179,292
82290,Gibraltar School District,07745,Downriver High School,57,5,26,88
82290,Gibraltar School District,08971,Gibraltar Early Child Education Center,11,0,13,24
82300,Grosse Ile Township Schools,01510,Grosse Ile Middle School,29,8,415,452
82300,Grosse Ile Township Schools,01511,Grosse Ile High School,28,4,617,649
82300,Grosse Ile Township Schools,02948,Parke Lane Elementary School,25,10,302,337
82300,Grosse Ile Township Schools,05712,Meridian Elementary School,29,11,374,414
82320,City of Harper Woods Schools,00233,Beacon Elementary School,203,21,98,322
82320,City of Harper Woods Schools,01578,Harper Woods High School,284,34,176,494
82320,City of Harper Woods Schools,04240,Tyrone Elementary School,182,17,103,302
82320,City of Harper Woods Schools,09753,Harper Woods Middle School,131,18,78,227
82340,Huron School District,00208,Huron AI Center Progam,0,0,6,6
82340,Huron School District,01799,Huron High School,159,57,651,867
82340,Huron School District,03219,Brown Elementary School,142,32,293,467
82340,Huron School District,05184,Carl T. Renton Jr. High School,144,35,419,598
82340,Huron School District,05780,William D. Miller Elem. School,100,28,267,395
82340,Huron School District,08748,Sunnyside Kindergarten Center,54,7,100,161
82365,Woodhaven-Brownstown School District,00216,Bates Elementary School,147,29,302,478
82365,Woodhaven-Brownstown School District,05298,Brownstown Middle School,198,52,521,771
82365,Woodhaven-Brownstown School District,06131,Yake Elementary School,136,18,319,473
82365,Woodhaven-Brownstown School District,06288,Woodhaven High School,274,83,888,1245
82365,Woodhaven-Brownstown School District,06420,Gudith Elementary School,162,31,228,421
82365,Woodhaven-Brownstown School District,06682,Erving Elementary School,132,43,292,467
82365,Woodhaven-Brownstown School District,06683,Patrick Henry Middle School,212,55,521,788
82365,Woodhaven-Brownstown School District,06825,Wegienka Elementary School,113,25,285,423
82390,Northville Public Schools,00083,Amerman Elementary School,12,4,538,554
82390,Northville Public Schools,02770,Cooke School,85,7,73,165
82390,Northville Public Schools,02772,Northville High School,55,15,2109,2179
82390,Northville Public Schools,05283,Moraine Elementary School,11,6,440,457
82390,Northville Public Schools,06591,Meads Mill Middle School,33,6,863,902
82390,Northville Public Schools,06592,Silver Springs Elementary School,33,6,430,469
82390,Northville Public Schools,06593,Winchester Elementary School,6,0,508,514
82390,Northville Public Schools,06707,Old Village School,40,9,68,117
82390,Northville Public Schools,07964,Thornton Creek Elementary School,8,1,441,450
82390,Northville Public Schools,08803,Hillside Middle School,18,10,819,847
82390,Northville Public Schools,09087,Main Street School,0,0,32,32
82390,Northville Public Schools,09171,Ridge Wood Elementary School,15,0,613,628
82400,Riverview Community School District,01796,Huntington Elementary School,73,16,203,292
82400,Riverview Community School District,02509,Memorial Elementary School,160,44,216,420
82400,Riverview Community School District,03222,Riverview Community High School,153,40,724,917
82400,Riverview Community School District,03436,Seitz Middle School,164,60,422,646
82400,Riverview Community School District,07423,Forest Elementary School,89,23,305,417
82405,Southgate Community School District,00454,Grogan Elementary School,178,51,171,400
82405,Southgate Community School District,00681,Chormann Elem School,102,25,179,306
82405,Southgate Community School District,00875,Davidson Middle School,291,81,454,826
82405,Southgate Community School District,01260,Fordline Elementary School,120,29,140,289
82405,Southgate Community School District,02956,Asher School,201,0,475,676
82405,Southgate Community School District,03544,Southgate Anderson High School,277,109,832,1218
82405,Southgate Community School District,05179,Allen Elementary School,125,39,181,345
82405,Southgate Community School District,05405,Shelters Elementary School,179,28,150,357
82405,Southgate Community School District,06161,North Pointe Elementary School,119,30,199,348
82405,Southgate Community School District,06297,Gerisch Middle School,317,85,373,775
82405,Southgate Community School District,07777,Beacon Day Treatment Center,61,0,84,145
82405,Southgate Community School District,08962,Sp Ed - Transitions,6,0,13,19
82430,Van Buren Public Schools,00263,South Middle School,211,37,311,559
82430,Van Buren Public Schools,00264,Belleville High School,512,86,1077,1675
82430,Van Buren Public Schools,01071,Edgemont Elementary School,196,33,273,502
82430,Van Buren Public Schools,01130,Elwell Elementary School,197,30,89,316
82430,Van Buren Public Schools,01533,Haggerty Elementary School,174,41,230,445
82430,Van Buren Public Schools,03157,Rawsonville Elementary School,326,26,110,462
82430,Van Buren Public Schools,05988,North Middle School,317,49,323,689
82430,Van Buren Public Schools,06826,Tyler Road Elementary School,190,27,313,530
82430,Van Buren Public Schools,06827,Savage Road Elementary School,114,28,193,335
82430,Van Buren Public Schools,08882,Early Childhood Development Center--ECDC,22,2,61,85
82430,Van Buren Public Schools,09546,Van Buren Alternative Education School,84,15,57,156
82701,University Preparatory Science and Math (PSAD),09907,University Preparatory Science and Math (PSAD),192,38,152,382
82702,University Preparatory Academy,09887,University Preparatory Academy (PSAD) - Elementary,245,36,62,343
82702,University Preparatory Academy,09888,University Preparatory Academy (PSAD) - Middle,302,38,63,403
82702,University Preparatory Academy,09889,University Preparatory Academy (PSAD)-High School,344,50,133,527
82702,University Preparatory Academy,09908,University Preparatory Academy (PSAD) Elementary,254,44,86,384
82703,Henry Ford Academy: School for Creative Studies (PSAD),00101,Henry Ford Academy: School for Creative Studies (PSAD),216,58,108,382
82716,Vista Meadows Academy,09906,Vista Meadows Academy,51,0,10,61
82717,Achieve Charter Academy,00110,Achieve Charter Academy,48,16,499,563
82718,Quest Charter Academy,00097,Quest Charter Academy,196,35,100,331
82719,Washington-Parks Academy,00132,Washington-Parks Academy,147,26,150,323
82720,Lincoln-King Academy,00133,Lincoln-King Academy,147,21,116,284
82721,McGivney Academy (SDA),00182,McGivney Academy (SDA),3,0,10,13
82902,Casa Richard Academy,08046,Casa Richard Academy,98,14,24,136
82903,Aisha Shule/WEB Dubois Prep. Academy School,08047,Aisha Shule/WEB Dubois Prep. Academy School,211,5,32,248
82904,Plymouth Educational Center,08255,Plymouth Educational Center,651,112,153,916
82904,Plymouth Educational Center,09946,Plymouth Educational Center - Youthville Site,125,23,79,227
82905,Nataki Talibah Schoolhouse of Detroit,08256,Nataki Talibah Schoolhouse of Detroit,254,10,132,396
82907,Michigan Technical Academy,08261,Michigan Technical Academy High School,350,35,105,490
82907,Michigan Technical Academy,08865,Michigan Technical Academy Middle School,225,18,34,277
82907,Michigan Technical Academy,09099,Michigan Technical Academy Elementary,200,8,27,235
82907,Michigan Technical Academy,09483,Michigan Technical Academy,223,12,6,241
82909,Academy of Detroit-West,08950,Academy of Detroit-West,271,24,26,321
82910,"Martin Luther King, Jr. Education Center Academy",07425,"Martin Luther King, Jr. Education Center Academy",251,15,48,314
82911,Gaudior Academy,07597,Gaudior Academy,113,25,53,191
82912,Academy of Westland,08334,Academy of Westland,375,17,32,424
82913,Woodward Academy,08335,Woodward Academy,443,57,58,558
82914,Colin Powell Academy,08336,Colin Powell Academy,267,10,10,287
82914,Colin Powell Academy,09934,Colin Powell Academy - Middle School,253,18,33,304
82915,Eaton Academy,08337,Eaton Academy,335,38,94,467
82916,Summit Academy,08338,Summit Academy,190,43,172,405
82917,Michigan Health Academy,08346,Michigan Health Academy,161,3,39,203
82918,Cesar Chavez Academy,00173,Cesar Chavez Academy Intermediate,234,10,0,244
82918,Cesar Chavez Academy,08347,Cesar Chavez Academy Elementary,421,10,3,434
82918,Cesar Chavez Academy,08569,Cesar Chavez Middle School,514,21,17,552
82918,Cesar Chavez Academy,09153,Cesar Chavez High School,573,18,28,619
82919,Commonwealth Community Devel. Academy,08656,Commonwealth Community Development Academy,238,9,5,252
82921,Academy for Business and Technology,08435,Academy for Business and Technology High School,297,29,33,359
82921,Academy for Business and Technology,09332,Academy for Business and Technology Elementary,248,27,19,294
82922,Nsoroma Institute,07606,Nsoroma Institute,146,20,27,193
82923,Chandler Park Academy,08454,Chandler Park Academy - Middle School,139,10,13,162
82923,Chandler Park Academy,08915,Chandler Park Academy - Elementary,877,65,125,1067
82923,Chandler Park Academy,09825,Chandler Park Academy - High School,402,23,65,490
82924,Marvin L. Winans Academy of Performing Arts,08455,Winans Academy High School,132,26,75,233
82924,Marvin L. Winans Academy of Performing Arts,09705,Marvin L. Winans Academy of Performing Arts Elem.,612,63,142,817
82924,Marvin L. Winans Academy of Performing Arts,09914,Winans Academy Middle School,234,32,91,357
82925,Detroit Community Schools,08456,Detroit Community Schools-High School,515,40,69,624
82925,Detroit Community Schools,09619,Detroit Community Schools-Elementary,319,14,101,434
82926,Henry Ford Academy,08471,Henry Ford Academy,188,55,236,479
82927,HEART Academy,08472,HEART Academy,160,22,38,220
82928,The Dearborn Academy,08479,The Dearborn Academy,453,7,21,481
82929,Detroit Academy of Arts and Sciences,08489,Detroit Academy of Arts and Sciences,785,41,149,975
82929,Detroit Academy of Arts and Sciences,08945,Detroit Academy of Arts and Sciences Middle School,183,13,25,221
82929,Detroit Academy of Arts and Sciences,09420,Detroit Academy of Arts and Sciences High School,467,18,174,659
82930,Dove Academy of Detroit,08501,Dove Academy of Detroit,400,23,46,469
82933,Timbuktu Academy of Science and Technology,08572,Timbuktu Academy of Science and Technology,317,7,12,336
82937,George Crockett Academy,08635,George Crockett Academy,347,14,26,387
82937,George Crockett Academy,09156,George Crockett Consortium High School,31,2,12,45
82938,Summit Academy North,08634,Summit Academy North High School,148,39,335,522
82938,Summit Academy North,08906,Summit Academy North Middle School,159,37,229,425
82938,Summit Academy North,08907,Summit Academy North Elementary School,228,67,243,538
82939,Pierre Toussaint Academy,08630,Pierre Toussaint Academy,395,15,45,455
82940,Voyageur Academy,08631,Voyageur Academy,294,19,21,334
82940,Voyageur Academy,09154,Voyageur Consortium High School,320,33,111,464
82941,Star International Academy,08636,Star International Academy,1040,117,147,1304
82942,Hope Academy,08637,Hope Academy,453,0,44,497
82943,Weston Preparatory Academy,08641,Weston Preparatory Academy,296,27,83,406
82945,Edison Public School Academy,08651,Edison Public School Academy,596,134,345,1075
82947,David Ellis Academy,08670,David Ellis Academy,189,45,86,320
82948,Ross Hill Academy,08669,Ross/Hill Academy-Elementary,98,3,6,107
82948,Ross Hill Academy,08990,Ross/Hill Academy-High,63,6,10,79
82949,Center for Literacy and Creativity,08668,Center for Literacy and Creativity,79,4,33,116
82950,Universal Academy,08671,Universal Academy,473,4,23,500
82953,Detroit Service Learning Academy,08704,Detroit Service Learning Academy,812,98,218,1128
82955,Allen Academy,09319,Allen Academy,1007,7,46,1060
82956,Old Redford Academy,08723,Old Redford Academy - Elementary,552,57,85,694
82956,Old Redford Academy,09480,Old Redford Academy - Middle,305,34,70,409
82956,Old Redford Academy,09481,Old Redford Academy - High,552,75,177,804
82957,Hope of Detroit Academy,08722,Hope of Detroit Academy,420,12,23,455
82957,Hope of Detroit Academy,09155,Hope of Detroit Academy Consortium High School,17,0,16,33
82958,Joy Preparatory Academy,08718,Joy Preparatory Academy,144,5,3,152
82958,Joy Preparatory Academy,09318,Joy Preparatory Academy,276,13,23,312
82959,West Village Academy,08733,West Village Academy,312,33,58,403
82960,Cherry Hill School of Performing Arts,08730,Cherry Hill School of Performing Arts,861,21,173,1055
82961,Academy of Inkster,08729,Academy of Inkster,172,10,18,200
82962,New Beginnings Academy,08742,New Beginnings Academy,121,15,48,184
82963,George Washington Carver Academy,08757,George Washington Carver Academy,463,1,31,495
82964,Detroit Midtown Academy,08785,Detroit Midtown Academy,301,0,21,322
82967,Metro Charter Academy,08799,Metro Charter Academy,338,72,311,721
82968,Canton Charter Academy,08816,Canton Charter Academy,60,26,625,711
82969,Creative Montessori Academy,08853,Creative Montessori Academy,200,72,382,654
82970,Warrendale Charter Academy,08934,Warrendale Charter Academy,602,39,88,729
82971,Blanche Kelso Bruce Academy,09142,Blanche Kelso Bruce Academy-Connor,145,0,11,156
82971,Blanche Kelso Bruce Academy,09611,Blanche Kelso Bruce Academy-Wolverine,21,0,6,27
82971,Blanche Kelso Bruce Academy,09612,Blanche Kelso Bruce Academy-St. Jude's,10,0,2,12
82971,Blanche Kelso Bruce Academy,09613,Blanche Kelso Bruce Academy-Victor's,17,0,0,17
82971,Blanche Kelso Bruce Academy,09618,Blanche Kelso Bruce Academy-DePaul,29,0,1,30
82971,Blanche Kelso Bruce Academy,09707,Blanche Kelso Bruce Academy-St. Antoine,202,0,58,260
82973,Trillium Academy,09094,Trillium Academy,343,47,337,727
82974,Detroit Merit Charter Academy,09102,Detroit Merit Charter Academy,544,52,121,717
82975,Riverside Academy,09300,Riverside Academy,532,9,12,553
82975,Riverside Academy,09604,Riverside Academy - West Campus,455,11,8,474
82976,Keystone Academy,09306,Keystone Academy,129,53,564,746
82977,Hamtramck Academy,09307,Hamtramck Academy,425,17,38,480
82978,Life Skills Center of Metropolitan Detroit,09419,Life Skills Center of Metropolitan Detroit,278,11,52,341
82979,Detroit Enterprise Academy,09462,Detroit Enterprise Academy,576,60,65,701
82980,"Business Entrepreneurship, Science, Tech. Academy",09472,"Business Entrepreneurship, Science, Tech. Academy",432,2,3,437
82981,American Montessori Academy,00196,American Montessori Academy Upper Elementary,49,7,136,192
82981,American Montessori Academy,09457,American Montessori Academy,64,11,179,254
82982,Universal Learning Academy,09827,Universal Learning Academy,303,26,26,355
82982,Universal Learning Academy,09940,Universal Learning Academy - PK-K,93,11,11,115
82983,Bridge Academy,09464,Bridge Academy,581,0,5,586
82984,Dr. Charles Drew Academy,09605,Dr. Charles Drew Academy,375,9,35,419
82985,Detroit Premier Academy,09600,Detroit Premier Academy,622,40,77,739
82986,Hanley International Academy,09606,Hanley International Academy,535,17,62,614
82987,Frontier International Academy,09609,Frontier International Academy,321,0,5,326
82988,Discovery Arts and Technology PSA,09607,Discovery Arts and Technology PSA,194,7,19,220
82989,Covenant House Life Skills Center West,09624,Covenant House Life Skills Center West,172,5,74,251
82990,Covenant House Life Skills Center East,09621,Covenant House Life Skills Center East,251,0,62,313
82991,Covenant House Life Skills Center Central,09649,Covenant House Life Skills Center Central,300,1,18,319
82992,Northpointe Academy,09615,Northpointe Academy,234,4,31,269
82994,David Ellis Academy West,09710,David Ellis Academy West,489,70,275,834
82995,Taylor Exemplar Academy,09709,Taylor Exemplar Academy,280,95,302,677
82996,Clara B. Ford Academy (SDA),09787,Clara B. Ford Academy (SDA),178,0,9,187
82997,Flagship Charter Academy,09785,Flagship Charter Academy,513,24,40,577
82998,ACE Academy (SDA),09823,ACE Academy (SDA) - Calumet Center,79,0,22,101
82998,ACE Academy (SDA),09850,ACE Academy (SDA) - Lincoln Center,82,0,4,86
83000,Wexford-Missaukee ISD,08873,Wexford-Missaukee ISD Special Education,70,1,23,94
83010,Cadillac Area Public Schools,00487,Cadillac Junior High School,188,44,287,519
83010,Cadillac Area Public Schools,00488,Cadillac Senior High School,173,47,454,674
83010,Cadillac Area Public Schools,01307,Franklin Elementary School,184,24,138,346
83010,Cadillac Area Public Schools,02024,Kenwood Elementary School,215,21,99,335
83010,Cadillac Area Public Schools,02210,Lincoln Elementary School,143,24,83,250
83010,Cadillac Area Public Schools,02480,McKinley Elementary School,118,17,89,224
83010,Cadillac Area Public Schools,05101,Forest View Elementary School,116,33,166,315
83010,Cadillac Area Public Schools,07271,Cooley School,85,4,62,151
83010,Cadillac Area Public Schools,08628,Mackinaw Trail Middle School,198,33,205,436
83060,Manton Consolidated Schools,02343,Manton Consolidated High School,170,38,146,354
83060,Manton Consolidated Schools,05901,Manton Consolidated Elem. School,195,47,118,360
83060,Manton Consolidated Schools,08301,Manton Consolidated Middle School,164,39,98,301
83070,Mesick Consolidated Schools,02527,Floyd M. Jewett Elem. School,176,23,75,274
83070,Mesick Consolidated Schools,05866,Mesick Consolidated High School,118,23,115,256
83070,Mesick Consolidated Schools,08614,Mesick Middle School,137,26,59,222
84050,Michigan School f/t Deaf/MDE-LIO,02548,Michigan School for the Deaf,30,17,37,84